Aletzz_619	man
ForeverMoreVids	mom
kellydonlin	girl
whoopy07	man
SDMilitaryWife	mother
karacantrell	mom
rltaylor22	man
GiniMomof9	mom
tmj_mad_manuf	man
InsourceInc	trans
Frgluver28	mom
iMixShows901	man
KathrynMarquis	mother
brianjdixon	dad
MADFABstyle	girl
IamXiaoChen	dad
_ignaciolm	man
vitatrain4life	mom
polopirate	man
NiCOLE_SANDRA	girl
Pastordude	father
SavvyLeigh87	mother
photolarry	queer
Maka_Aruban	man
JenevaMarieeee	man
LaundryDayBlues	mother
JStormspotter	andro
tomkelly_ussa	man
digitalKaren	aunt
SeanieMic	man
russ_jokes	father
tmj_OH_facmgmt	man
bjlampley	father
ItsRosaMarie	boy
ContempoMode	man
Pattiewack	trans
lissa_vanh	man
DJTHEBAYBOY	boy
ilybellah	girl
RuckNation	man
LIDOWORLD	man
MTP_Dallas	boy
jhallmd	dad
Chan_Mark89	dad
KatinaLGranger	mom
mikefassetta	dad
heathergiustino	mama
owensdad00	father
andrewgerbetz	man
tmj_MD_transp	trans
AnneDiPrizio	mom
evangelistaChev	father
WeRunVirtual	mom
RyanJorEl	father
LilMissMuddy	aunt
gingineer87	mother
wildmediainc	mother
pierrejrobinson	man
marnmatt77	brother
grlwitOUTcancer	girl
thegoddesscher	mother
NickAtNight88	man
ACUSeth	father
christianxbomar	boy
ThatMattClement	dad
Rashontae	girl
jennie_heinl	girl
Shizzthebarber1	man
MarcoRod	father
GinManCounselor	man
msmaverickmuse	trans
ChesneyGirl09	girl
NicoleDukeNow	mom
DemitriusThorn	man
AUstanfsc23	sister
laurenfrancesca	man
MyBrownBaby	mom
meggerah	man
NMRoy	man
Paulrodrigohb	man
ChrisEconomidis	father
quynhchaustone	mother
ChefDadSteve	father
CMGregorio1	boy
NiceLadyThought	man
highcompgarage	man
1965us	man
djseantildawn	man
Allaboutlashay	mother
jakepotter	dad
SA_Crimson_Idol	brother
Meldenius	man
dejonshepard	man
miller_mindy	boy
Dustyisawesome	father
RicoZ17	man
ChuyGomez	dad
jeanajuice	mom
JCarterLA	man
paquitovedder	man
tylergrissom	dad
mromanmanson	mama
WineWonkette	man
mcj545	boy
zzzzzoar	man
Malik_Lotta	man
dude1bry	father
anick626	man
misskrystleg	mom
anamarietv	girl
Twitches_89	mom
PhilBamBamDaru	man
Regenerationss	trans
rwmedlock	man
ChvzAndrea	girl
LuchettiJordana	girl
johnypacha	mama
majestadd	man
nicsleeva243	mom
billclevenger	father
tmj_KS_transp	trans
jcb_cummings	man
MatthewReese31	dad
iwantabeard	brother
anegreira	andro
tmj_WY_transp	trans
tmj_nyc_transp	trans
dauntizzle	boy
maddkati	boy
LandOfHov	father
ShawnPrynce	father
ZappComics	man
scrapbook1_t	mom
MissAnaXB	aunt
profmadosi	man
AdelineLacaze	girl
Miz_Mora	girl
Wilcoxjd45209	father
taeisme	andro
DJMANO_COM	man
adelegriffin	girl
FunSize_Que	man
fourthofJuli	man
AMBmakeupartist	man
StephRomanovich	mother
margotgruen	man
WethingtonKeith	man
jaredwburns	uncle
jayjoy3	man
RE_SantaClarita	girl
angelomartinez	man
ProfessorAnaya	brother
ReuBot2000	man
Meggalooch	mother
ChrisHoneycutt	dad
biggtwon	dad
tmj_VAV_transp	trans
MiaLevittRizzo	man
King118	man
BUNKERTOR100	boy
susan_yeoman	mom
msjutras	mom
mdolemite	man
jhsiders	dad
heliman406	dad
buyerman120	boy
inkdgirl55	mom
homerandruth	mom
Beckywhokid54	brother
mixxula	dad
EduKickSoccer	man
kaykayholley	dad
drewrobertsmith	man
rebeccakayati	mom
Pain1381	father
kloo_amanda	mom
brianvelasquez	father
ldjemixon	mother
GirlMeetGrowler	girl
dowens3003	man
horwad	man
tmj_njn_hr	man
RunnerGirlChels	man
ultranatemusic	girl
Moe24P	man
winyourlifemn	father
ccolwell19	man
ninadioz	man
msk_enterprises	mother
micahfries	dad
Bhambelcanto	girl
mel_boates	mom
bulgarianalien	man
LauraRunning	mom
_pixiechrist	man
danaCreative	dad
donaldistiny	man
baileyelyse14	girl
sidecarhammond	man
alcav54	father
KingJamesLive	man
QolsysInc	man
PacCatchCOO	father
Deemack44	man
OluRicky	man
panderson1988	trans
EnmanuelGarciaV	man
HerbertHistory	dad
jayjuiceee	girl
SarahSarpolis	mom
DDandtheB	man
neilfrotten	man
SherrilynChang	girl
RebeccaYarros	mom
monclair_3	dad
shashankNYC	man
Julie_Garmon	mother
standingidlyby	andro
amyestradamusic	girl
morgan_tinka	mom
DougWhitesidedw	dad
brueckj23	trans
hobbit138	mom
doreenmari	mom
kkleman96	man
AaronJustis	man
chontaymeshele	mom
helenrwu	mom
511nyAlbany	trans
mikeybob	father
DJVallentine	trans
gkdave	father
BillFrino	brother
A_nieashia_96	mother
codyplof	man
Eyenoticed_	girl
petesart	man
funkyfemmie	girl
familydocwonk	man
turleymac	father
JacobRogers07	dad
GezetaInc	man
DreamInKode	brother
blowpopsreviews	queer
GordyPrather	father
MrsEmama30	mama
NerdFitter	girl
TamanGyrl	man
SNAPBACKKIIDD	boy
chitownDJ	boy
ICYUNVC	mom
LisaG_325	girl
DennisCashMusic	man
joydances	mama
fancy1978	mother
deveautrain	mother
smcanally13	sister
45Jmitchell	man
cyclesnack	father
StonesiferAmy	man
gabendiote	papa
tmj_den_hr	man
PrixO	mom
Amburberryy	mother
NAATNM	man
errnbrrn	man
galenzamarra	man
f8c3dd3dec6d4f8	mother
AndieBSimon	mom
mikey_segura	boy
tmj_tuc_transp	trans
johnmc703	man
NaviPromo	man
beat2394	girl
samdotson_	mom
jbwhitby	dad
ceomus	father
jhornamakeup	mama
elizgillett	trans
Bless_By_God	man
Shawn_TRUKFIT	boy
Bikini_koko	girl
Carly_Ramirez	man
jabaristaffz	man
Dallas_B	father
deefirecracker	mom
ericthewheeler	man
MTJewelryGal	man
bjboulden	father
johnespy	man
markie_mantle	man
Kimmy514	mom
ChantelNasits	mom
sprout3292	mother
OGMVRiE_	mother
Stacy322	man
cdistasixxx	boy
EugeTindall	father
ponsartt	man
OlenaGisys	girl
AnySpine	man
AmandaEliseLanz	man
olivedearest92	sister
jenebasuma	man
ManuelScott	man
KombustionMoto	man
RMDreier	girl
HathawayBrown	girl
Inbatmanscloset	man
DaveErving	man
JoseMyFatherCig	father
Philfought	man
patrick_mooney	trans
IreneKamau78	man
KersleyGirl	girl
Marquisnipes	man
manutdeal	man
AkashaOhara	girl
Barb_Tender	girl
miss_burky	boy
YourVacayMyHome	girl
joelvictorian	father
IllustrisEnt	man
GinMinsky	sister
CStringerphoto	mom
Fashion101ed	girl
janicehostager	mother
erika	man
Lowecat	aunt
MrsBitt	girl
CoachBWestbrook	father
danmckelvey	dad
terisaterror	mother
stevenbwalters	man
kursatcalisir	man
aileenholmes	girl
Colleenprchick	mom
_ALGHREEB	mama
RagingDaisy	mom
euclidg	boy
levidoc07	mother
thejessrad	trans
chrissiverhus	man
DromeBoxLabs	man
AlannahWoodring	man
afocante	dad
BarzzNet	andro
Na_No_Pressure	man
christinaolivaa	man
Aagrusin	trans
kaceymontoya	boy
theclubchick	man
JillieReil	mom
xoxoaudreyjean	mom
alexkballard	girl
ChrisShort	father
Steven_626	man
OMEB1	man
RickLeeJames	dad
theREALbwitcher	brother
nferno	man
cklassen25	girl
agomezgo	dad
OVashti	mother
TheresaConverse	man
regina_somers	mom
CraZ4_48	mom
heathergirl	trans
bryonbos	father
Charliequigleyy	girl
avitatattoo	man
AGirlCalledD	mother
stevegeyer	dad
Miss_Graves	girl
BrentonBean	father
CJMacBeathW	man
ArbonneBeth	mom
ItsMilaunaJemai	sister
Motor_Dr	father
PKII_	man
FRINGEandFRANGE	man
Lyzard83	trans
wyattellsworth	man
bertosaid	man
bryanclay	dad
RD_Gilchrist	father
Soaptopia	man
stephberrryy	man
webdesignSedona	man
iswguaymas	dad
Alex_GUAX	man
RhondaSmith301	mom
EuroGirl64	mother
HC_Youmans	mom
BWall	man
BLeeMuller	man
lisapliner	mother
nrobst	father
InvManFilm	man
sober_mom	mom
djchrisstyles	dad
katiegreene47	girl
4BarryAnderson	boy
_katieco	man
KrisandraRae	mom
MegLeigh2012	mom
tmj_NC_transp	trans
tedddavisevents	man
mrscsawyer	mother
TaylorFisher	man
TheWatererBoy	man
grantmitchell09	man
Poni_Boy	man
JessNotJazz	man
keepmymarbles	man
LukeOlsen_Music	man
bayareaskbeats	girl
tmj_chi_transp	trans
frbobo	man
AshleyGoodlett	mother
Jgarverick	father
taybecmyers	girl
Jason86590181	man
mollyteitelbaum	girl
RTRCrystal	mom
CAKKBabst	mom
susieduarte	mom
tmj_tpa_manuf	man
HorneUltimatum	man
tmj_CO_facmgmt	man
SamSmette	man
kaitmcdadefit	dad
babypunkin	girl
CocoChanell1	girl
FG_NOLA	man
RoShE_RyAn	mom
christahann	girl
jimmy_u	dad
teresa_bragado	mom
BihJoBe	male
OffTheHookOKC	man
loboooeno	dad
_DK22	man
bigbmusic1	father
tmj_dtw_hr	man
JerrysGoddess	man
Sharpe1Dave	father
tmj_wi_hr	man
KennedyTerri	mom
RandiMartos	girl
EnigmaRDT	uncle
MadiMae910	man
RealRomaDowney	boy
LNRisk_Jobs	man
AlexLeeNorwood	man
ronebrooks80	father
NoJodasGracias	man
wrwhaley	dad
TheJeremyLopez	man
taydiddy	boy
triveraguy	man
RaymondJoycePho	mom
JCorcione	man
LAonCloud9	man
mcflytasha	man
SmarttImages	mom
RachelZatcoff	girl
davidzendoval	man
MossBuildDesign	mom
Monicagomez___	mom
adrianaximenagr	man
KennyCamposNYC	trans
KYCharlotte	girl
BumpClubChicago	mom
lisainouye	man
BigPeteJRCapo	boy
MbkMentoring	brother
drkarenhorton	mom
DonnySinsXXX	male
galeagustavo	dad
CooperRobinson3	man
ChiLdish510	man
cypresswalls	father
ShaunaGallagher	man
jesus_paniagua3	man
1acslater	dad
danap2170	trans
eddyg32	man
DaphneUn	man
Mdawwg16	girl
LEXISIS1	mom
annegeni	girl
bmorelawyer	father
cwondn	father
stuartelwell	father
javi_reylez	man
carabertrand	mother
DanielRivera_x	man
amolloy	man
ShoreboundHero	father
iRAWniQ	girl
TaperJeanLadyK	man
sullivan_lynne	mom
AngryAccountant	dad
BenchmadeKnives	man
llroyjetson	dad
mikelmama	man
MILRO1000	man
Kranzo	man
Disalani	man
ssbuffett	trans
AlbertoBaalbaki	man
joeref	man
momoftwinswblep	mom
MJennine13	mom
GlorGD14	man
MoeAlafrangy	man
BethanyRenee29	man
HAIRDIVA29	mother
BeebAshcroft	man
lucentrip	mother
i_am_B_Chill	father
sirkain	man
JustinLynnJames	man
GaryThomas56	father
aldenellis	dad
Gaboavenda	dad
supersawyer84	father
gyarugarou	trans
TonySourcer_TD	man
ChefMHidalgo	man
GildedyTableaux	man
_linton	dad
IndyZenPoker	dad
SANGIMINAJ	aunt
philipbgriffin	father
CityEMA	man
JayeRose13	boy
niktastik	mom
PHAtraveler	man
Eric_Harter10	father
ChiBastard	dad
dutchnewmanis	mom
BethWheatley	man
CamiBenteo	man
put0ypendej0	queer
ssobbell	man
billhelm	dad
803BiRoN803	boy
MindyConnects	aunt
joncalos	dad
regiesy	man
Suppositori	gender
dalifr	man
Treys_Ambition	man
MikeDfitness	man
blisswithmac	mom
DJRosie	mom
CSweetbottom	girl
misstrace0122	mother
giovanniguido	mom
DeathMonkeyMMA	boy
BCBgrunt	brother
BizzyB85	man
CoryDDMiller	man
ericaiscreative	mom
drunkphilosofy	mother
KidMixPhoto	father
Kemi810	girl
VntgBaublesnBit	girl
Claud_Oval	mama
janice_valenc	girl
HelsinHashtags	man
wildmeredith	man
tmj_roc_manuf	man
_socheryl	mama
groove_team_jay	boy
kem7474	mom
missmorganjj	girl
MattyRevengeFYS	man
caitlynshaw1	mom
LuV_RaYbElLa	dad
Lukester919	boy
Pacman_i95	man
7ucky7efty	man
JaymeFoxx	girl
daria1275	girl
david_mc	father
Yesssyolma	mother
billyhough	uncle
chrisandxbones	girl
jk15chef	father
MrRankdizzle	brother
gabygaonam	dad
purpledonnelly	girl
mattbeninghof	man
heeeraldo	man
theemperor129	man
JasonBCole	dad
Silly_Rican71	father
BubbleCrumb	mom
Bonez69ad	man
marcusethan	man
amysullivan715	mom
tmj_NE_facmgmt	man
hijinxpr	man
NikosSiozos	man
NubianMech	mom
TheRonWi	man
AlexandraMC96	man
andreawebb1	man
M1st_Corz	man
tmj_az_manuf	man
OneNoahGuerrero	sister
IndyOreo	dad
l_p_348	mama
FacilitiesMedia	man
nickslick6	man
krmbeu	girl
MadMike4883	man
metbaritone_06	trans
missfrannypants	man
CarlyAThorne	trans
Melaniedatbitch	trans
konatasmall	man
melyy2513	mom
Ksiezniczkaquin	man
Flashmanwade	man
Djstantheman	man
Vixen1267	girl
logan_ulmer	girl
rodneybowers	man
GodModeTony	boy
Jute_bug	mother
benhckr	father
simplymaurice	mom
Mannyfresh2499	man
Edgar_LoyaRC87	man
mariahdanielsen	mama
STARWrap	father
LorraineJohnso	mother
bhayes76	man
jaywiseiwu	father
tmj_LAA_transp	trans
2GirlsInPearls	girl
allij04	girl
benasam	man
vicocazz2	dad
bpmoritz	dad
MikeSophia	dad
CarinaPotteiger	boy
OhSoVane	mom
Scotty_Pippen	mom
danielklapheke	man
amysimpson1968	mom
germanfest32	man
codyjhinton	father
dbrmarkiemark	man
PCPalmDesertCA	girl
screwtape21	father
rs_morrison	man
AngieShaghaghi	mom
tombatemann	man
mcpflugie	sister
jawill529	trans
MNChuck	man
KazeyKalloch	dad
RunJuly	man
TonyMikla	man
chadwstone	dad
Styxxoplix	man
BernyGilbey	man
IveBeenArman	man
janetteqb_	dad
jesuspavon	man
drmoll	queer
KellyyyXac16	man
surajstar	man
shaiyhoward	mom
CitlaCaceresSC	dad
PauMch96	man
Curvily	man
CallMeKilgore	trans
kiddkoro	aunt
iliv4gd	father
SLBassett	dad
KevinRoden	boy
jessica_crate	man
MacGirlie	girl
EpicCharmDesign	man
saiseihogo	dad
OMP_pgh	man
ArredondoVargas	dad
EileenZFuentes	mom
Chauncea	girl
YehoshuaSolomon	man
opallo30	brother
NBerberich	mom
jdrama418	boy
ayoforrachel	mom
hangrymichelle	girl
DsnyByKarina	mom
MarcVibbert	father
SadMeganGirls	girl
DJRYEIL	mom
JoseASaltos	man
ma_b29	dad
Hutch17	man
FlyChickLinds	mother
gourmand4life	man
CarlosManuel67	queer
Rach_Runs	mom
acecallwood	man
lostinaurora	man
runciecwc	man
BodySoulDaySpa	man
navylostb0y	boy
TheRacyRedhead	mom
mbbpepper	mother
littleleahs	mom
fosteryourstyle	man
KHThompson	man
WillPMoriarty	man
callidorisx	mom
ronozer	father
BraxtonJulie	man
jediaeljohnson	father
santigobay	father
popplewell_m	male
leen_bug	mother
ImJohnnyKelley	dad
Rene_Fierro_G	dad
dilani_r	man
Thormanj	father
juliekuzfrisbee	boy
JenniferNeily	mom
paincane	father
ONECTGIRL	girl
ronalf08	mom
Christie3Benson	mother
mmcdarby1	boy
jokermachineinc	man
CrystalKellner	mom
benewavvy	man
ICONPerformance	man
mbraceit	man
PAPERMONTANA	boy
abzamp	brother
828pantherfan	mom
KarlaFenomenal	brother
rustyglines	man
Philosophica82	man
geoff_calkins	father
KaraShobe	girl
jumzinc	man
huefa	man
Stephchannc	boy
Sporils7	man
PaulDvd69	man
MyEverydayLife_	mom
NickDuffyGolf	man
poptartdaddy	man
autumn_nora17	girl
ai3mcgrady	father
MalRoy_18	boy
missionslimposs	mom
nmaestas	dad
stephbreen54	mom
Scottorsini	dad
Augustacoromoto	man
SumSkybaby	mom
o_tunes	girl
tryansaurusrex	man
KristyVelasquez	mom
AlfaWorldATL	trans
KimChance2	mom
C4Jack	dad
catsimmie	trans
sechevarrias	man
addisonhoney	man
JaPharii757	man
xtinaa82	man
HTOWNBLKGOLFer	boy
RCRGRollerDerby	girl
YTKGo	man
marcodiaz72	man
rperez1972	man
OMartinezJr	father
TattleTav	girl
AngaliaBianca	man
chrisannhunt	girl
frederickercia	man
leamill23	man
MCScola	man
BAMROMANO	trans
76Cohen	girl
forevergenia	mother
SandraArenasPA	man
AngeliqueRoche	girl
cornmomma	girl
Hartman_Dental	man
Brook_Nikole15	sister
lazucker	man
Michael_Neff32	boy
tanjclark	boy
yourjohncalvin	man
PinupPam	girl
JaysonByrd	father
justinhankins	mom
LCintesis	man
AishaRasul	man
rickhew	man
LeoLondono	trans
DallWinther	mother
RevNicole	mom
tmj_chh_transp	trans
StormFitNation	father
trueblue0831	mother
barbetorium	man
ginasauruss	girl
CieraHardyman	man
GillesMontezin	man
mygiantrobot	girl
carlos_gm29	man
SeanathanVT	andro
FelixJacomino	dad
jamiecotemandra	man
mrshinumn	man
MsPrizzle	boy
slimmamma24	mother
djstevenice	dad
joanie109	mother
LeBig_Mac	dad
joshuacox	father
JeffreyParshall	boy
Ryorhino1785	dad
Senturion	father
MrJay091685	father
jjwarren97	girl
FridaChihuahua	sister
sunnyburlesque	man
DebraGaveglio	trans
KD3RN	father
CharlieHeck	boy
RaeWitte	man
TouringShikha	man
tmj_KAL_transp	trans
tmj_dfw_hr	man
viniciusrlima	dad
JohnBarlak	man
emdoublekay	man
cosmokazi	man
weainsworth	father
HenriBendel	girl
MU_SLAM	man
tmj_SC_transp	trans
marshy5365	mom
bonniepantelup	brother
cbuccieri	father
pastorjimlocke	dad
lightthathalo86	man
EeZeEpEe	andro
ViralNinja	man
aggie_judo_diva	man
CLevesqueDHG	man
tmj_slc_transp	trans
Ha_Ally	man
Eric_Melvin	father
anh_thule	trans
ElijahMorgano	father
vannamarie	mom
KineticTherapy	man
cvilchez	man
_sammyOG	man
4forNik	mom
NoblejayJesse	man
RichardSmithJr	mom
freddyeyes	father
boyswholovepink	boy
mikkathryn	boy
mace_facexoxo	girl
BlancaVNYC	dad
dnlee	father
what_if_i_said	mom
liz_sturrock	mom
joshuawjj	father
ouilicious	man
tmj_njc_manuf	man
CowboyKyle101	man
bpostofwc	man
C_Haberberger	boy
YoSoyVladman	dad
Cater2uSF	girl
lschneider0410	man
sumi_forwhat	man
MbMusgrove	boy
ExploreMidtown	man
paigedempsey5	man
PassionDanceTAM	man
WesWoodland	dad
Dloo_LayedBackk	man
wingandaprayerf	mom
carissaxx3	man
AndyLeavitt	man
FanciFACEbyKez	mom
vegeterryn	man
AudreySwanson26	man
rebel_rockzz	girl
Maikeme	man
Brevinjordan	man
ZavierSabio	man
mmmmaven	man
Porterhouse1974	man
sosarahsays	girl
mosspetite	girl
Drew_33	mom
DearJamieMR	trans
ImJustMaryC	mother
StyledBySkylar	man
_CrawfordGroup	man
DrDavidMillerND	man
blackfemarch	mother
barbyuel	mom
adrianacarlopez	girl
nicobach1	brother
718_Cyclery	dad
ashrrs	mom
studio921	mom
JBHosty	father
just_callme_rea	girl
monetsclaude	man
tbbinc3	man
tmj_WV_transp	trans
Texas_Babe13	mother
Tony2__	man
WillCollie	man
bttags	dad
mandileighh	man
bobaycock	father
MirabaiOfficial	man
ShawnVokals	man
rilla6969	dad
jetaimerenehair	man
DishOnParenting	mom
kglads4	man
SynthesisDNA	man
ManicPixiTravel	man
TavMike	dad
joeynavarro	dad
JaniceYuMoran	man
Pantherstar22	boy
anointedwives	mother
RePHocused	mom
JGuerc	girl
CLT_Hypnosis	man
PrincessaBrunna	girl
sugarshawnray	man
mojo_ca	man
Brian_Egan	man
jonsanderson5	father
Gay_BirdMom	mom
A_Kikani	man
byrdayala	man
McManagement613	man
Keith_MwauraKE	dad
Damek0Masca	girl
DaxJeter	man
zoezigenfus	dad
cathieroyer	man
caseadilla9	boy
BigDog112262	dad
VZam79	mom
sarahcaz10	girl
Djspice410	father
Mamastrosity	mama
WEARRicki	mom
MainEventPlayer	man
Keevieskia	mom
IiroLunki	man
SeanMMcNally	dad
ATLHollywoodKid	man
langstn	father
nmCaruso	mama
cadolfo	man
RobertBIrish	andro
geonitacka	man
BladeCraftBA	man
april412	mama
LSUduck	man
BiffGore	father
IAmJustNesh	man
iAmAngelX	man
KKoz03	mama
cacruz03	man
itsmecolint	dad
ChrisDenman	man
WadeBanner	man
jswain217	man
Mr_B_TSS	father
scotthockens	man
thinkshannon	mom
cassdoesla	girl
jazmataz3	dad
sarahdances	girl
RossHollebon	trans
lindseyshifley	mom
wendyc34	dad
tmj_grn_transp	trans
ERRoessler	man
JamieDawnBryan	mom
rakeshsatyal	boy
BrianKMorris	man
lobsterkmd	mom
Shashank_Maniar	man
Moekashmusic	man
tnicoleweddings	mama
Thaoriginalgata	mom
charworks	mom
ProducLOSPLEBES	dad
tcufrog05	mom
Papayon70	papa
JenTheEditor	mom
tmj_NEO_transp	trans
LilFred1_	man
chriswadepc	father
CrouchingMark	dad
phohurst	brother
ninadane	man
EGHtown	father
afoodobsession	father
RadioactivClown	girl
Cowboypowerspor	boy
Comedyablackman	man
crimebythebook	girl
francophile00	girl
rkinard	mom
AshleyLauren809	man
ehmandah	man
EscobarsUhMom_e	mother
FrancisSadac	man
KimHaCampbell	man
Raeanne_Roy	man
tmj_sat_manuf	man
JulieJxander	mother
sssemester	man
cheriestuff	girl
agee_david	father
JeremiahOsGo	father
VanilaSingh	mother
GuinevereMV	mom
jannieville	mom
JulesBonfante	mom
NYSantosh	dad
djEFN	man
BrunoPk25	andro
JayDoveDunston	father
SchmittsSaloon	brother
AmandaF_Batista	man
tromerhauser_	girl
VanityHairNYC	sister
psychokittyn	mother
cattleyyyy	girl
courtallen	mom
TravisLegge	father
Mexicanfloyd	mom
gonzzalovergara	man
MommyAngela3	boy
annelifjohnson	father
BrettMiller1988	man
FreeUP_us	man
alexismroark	man
nonsanaementis	man
BADJOHNPAUL	boy
JOHNRENGIFO	man
DarkestKnight79	man
krxs10c	girl
tmj_cin_hr	man
Gregg_Mau	father
feguiaorlando	dad
VellVegas	girl
Elyssion_	man
socalmoms	mom
AnnieKassens	mom
z_myst	man
SaraTweedy	mama
RichSavarie	papa
ZavierMcJr	man
ryandrake	father
tmj_MA_transp	trans
Jness326	man
lovetrish	girl
jgonzalezNYC	man
ChristinaShadle	man
reannepalmer	sister
zip100473	father
TeresaAnaC	mom
RKMCPHERSON2014	man
lbc42a	girl
obinwachukwu17	man
MsMoushaumi	mom
Ryan_J_Irwin	father
TheREAL_C_Unit	dad
kirudaze	girl
mystrangebones	mama
Flautomatic	man
curtchow	dad
aKatiej	girl
grantwhunter	father
kim_anh	man
kennewville	father
autodynamica	man
STACYFBABI	mama
strangek	man
tmj_orl_manuf	man
coachanthony01	man
brogannicolee	man
houseofbullock	father
FredGiovannitti	dad
GarratonJackie	mom
KittOMalley	mother
jonvox	queer
Nicky_Rizzles	man
HeisePete	man
BrandenAnthonyW	father
alukalani	mother
tommymccaul	father
MarcusRepublic	man
NoelBe_	man
ProSourcePrint	man
Indollablue	mom
only1divadee	mother
MissBitchToU	mother
salary_co	man
theparishouse	mother
Scott_Backman	girl
m1ssunshine	mom
UVAEquipment	man
Bassygroove	papa
CoachDrDre	dad
DanGlazer21	father
tmj_mi_manuf	man
realcroney	father
KieraDenise1225	mom
DrDtweeters	dad
hArRiSoNsApP	girl
VMZ10	boy
LesleyER	man
NPGENT	man
DeAiOhIn	father
BigDudeFoodMoe	man
4injuly	man
DPI_DANGLES	man
ryan_hite	dad
JakePerricone	dad
lissa_bellee	boy
RDeVitoIFS	man
bxsmith	dad
tmj_nyc_manuf	man
jourdanjewels	man
JoyGann	man
star4laughs	mom
KennethBurnett	dad
hisear4musik	man
meganlaughing	boy
RashellWeber	girl
PCarmichaelArt	mother
TheresaNasi	mother
linda_aldred	man
HukMan_	man
MARTYGETDOWN	man
misasongbird	mom
pezmama13	man
cayloe	man
Redmouse15	boy
JessLighthill	man
riley2cool	trans
bgoss	mom
thejohnnix	dad
amirshayegan	man
urbanfitopia	man
StylishPatina	trans
chrisfradin	man
kamala_chan	girl
JuicyAintShit	aunt
digitalsea57	man
THEREALDAVEJEFF	father
themattygroves	man
McGinnHomes	man
HamatoKameko	girl
jimurbanHRT	man
queengirligirl	girl
jphilbin84	father
abrhouston	man
tomxchao	man
bbroxey	dad
3DBillionaire	girl
WeatherByBrian	man
presidentiallv	trans
MelissaEperjesi	dad
Hydeclark	boy
ruitome	man
tmj_NV_transp	trans
NMSUinsider	trans
KTdrama27	man
tyusuf24	man
wmcraven	father
KacyTSDate	girl
HorsemenKingObi	boy
BARBIEK70	mom
heidela	mom
ThisTexan	boy
QBLP_Bill	aunt
nmcotelesse	mom
tmj_TX_transp	trans
thatgalkiki	mom
PastorTonyMoore	trans
jenvargas	man
bambrick3	father
PMandichSC	man
CassandraDanger	man
dmwilsonh	boy
PandaShotz	mom
danjswartz	man
jeffbriscoe	dad
dallas_frick	dad
IHearThatGirl	trans
HalieMilhorn	sister
Andi_S89	boy
christielli	girl
NelsonComedy	man
ChefHolloway	father
lilboyloges	binary
NYZCCC	trans
Veromafalda7	male
Crashfennec	girl
Coach_BrettB	man
Willgetitgoin	man
Chiusy	man
RonCarpioMSW	man
Jxxsy	girl
that_BrianMILLS	man
scottpenton	man
shannonnolde	mama
shophny	mama
profe_013	man
RakaRene	man
djpupdawg	man
roselivano	mother
ElGabRyan	father
jgodwinbrooks	girl
Khayslaw	father
UnkRam	girl
HistoryHoney	mom
Robert_Leader	man
DarthRader_	dad
kiddkannondmv	man
swirlina	queer
BernmeisterRL	girl
231Greg	male
Tymikia_Glenn	girl
tmj_ny_manuf	man
gglightbulb	mother
MollyHMorrissey	mom
truckmojo	mother
PepLlausas	boy
urrutiadelpozo	man
A2Dave77	girl
PonchoSebas	man
asthehosptuRNs	mom
tmj_NEG_transp	trans
stncurtis	trans
tmj_CT_transp	trans
chefmichone	man
teachitKate	sister
MPHennessey	man
CamBoyoCoffee	boy
gadgetboy	father
MiltonKicksIt	man
dianamdevlin	mother
swells1015	mom
TeresaZodom	mom
OlsonCon	father
tmj_mad_transp	trans
DJacobo92	man
dfreeman30	man
DJKingBori	man
filipinodiva	mother
brianflowaz	boy
DanaFazz	man
Craig_McD_Jr	girl
MNLunaBella	man
MaxManPacWell	man
soulfulrvfamily	boy
joessjonasONO	man
embalmerswife	mom
bellasegari	girl
JorgeDok	man
KimmyJones	mom
FreeFallin2k8	brother
murseboy1989	male
milestalbott	man
coloradoxmoo	man
tmj_usa_transp	trans
BeatlesDiva	girl
villesupreme7	man
jessicamfox82	mom
mlleraquel	mom
ColtonPorelle	man
gbdigital	man
FueraDeFoko	man
T_Harm0077	man
dtay2dtay2	mom
CodeRed714	man
NikkiWalkerPR	man
BethBecker2	mom
kaylynuke	mom
SunnyAkhigbe	boy
TrishaEmery	man
abadia24	man
LindsayStrauss	girl
chumpchampion	man
m0rc	mom
ggiron6765	mom
ContessaAnneB	aunt
RayKliewer	dad
LaurenRBrady	girl
jleemai	girl
KevinAlexKamai	man
erinboelhower	man
itsjesswhelan	girl
wilmer_m07	man
_steindog	man
thehillclanrock	mother
Sumoflam	father
KingzOfTwinz	man
JayKnightPhotos	father
SamFrankel_	mom
abhxo47	mother
RudeBoyPhotog	boy
marcomboy	boy
kristykinney	man
cbuser	man
bisonhawk	dad
nwkmanuf	man
SaraImrie	man
ggonzalez1024	mom
JoeLipari	man
DariaChuprys	man
LNYCE	girl
treybowles	father
DavidKaunang88	man
williamprickett	man
rmkarlin2	man
ikesplace	trans
tmj_OHD_transp	trans
FCBauman	dad
mjonez61	man
ernestgm	mother
RoaminRabbitt	man
lolapwright	mama
irockuroll_65	father
RossKohnstam1	man
kandie_d	mother
Vicky813	trans
Ben_Bass	man
PsycoMermaid	man
AsMeYo	mom
pattiblaine	mom
TinoBrelak	father
babidali	girl
Lynnchap	mother
King_Dom_X	mom
girlonmoveblog	girl
Giogarcia28	man
BBillieJ	mom
Letty_PeGo	man
JodiMcLean	girl
scottTgrossman	dad
_Just_B	girl
nmtntaeqx	girl
tmj_OR_transp	trans
TheFlipFlopWife	mom
GulfstreamGuy	father
Michlen	man
juggahnic	man
freeman_moscow	boy
_king_dp	dad
TaliaSatania	girl
mickij3	mom
Johnvelsor	father
JoinGlanbiaPN	man
DJDuceOne	boy
jillbicks	man
RNsoaring	trans
Trace_Cohen	man
larryfudge	dad
HelenaMarie	mom
Aaronvieyra	man
DoletteAlvarado	man
philrice	father
Weblogforfood	mother
JakeFoxx	boy
scottorr300	boy
artbyyou	girl
QawiSales	man
iOjeras	dad
BrandonkimBMW	man
justinwoulard	father
youthminmarcus	dad
LunaStarwind	girl
Sebz14	mom
WavyLilly921	mom
LeeForTree	man
tigerxctf	girl
MattSoleyn	man
Katelin_H	boy
AdamJuarez	man
ohmygil	man
TerenceRWms	dad
MitchellPittman	man
charlotteross	mama
spikeheelgirl	mother
MirandaSman	man
PelzmanDexter	man
DeWilfondMaddie	mom
TheDentoronto	mom
KittyKat_KID	girl
cherissek	man
_tonyinmycity	man
Matthew_Gallant	man
tmj_har_transp	trans
AstroCaribe	man
GerardoSalgadoR	man
DirtySailorGirl	man
BKunneke	father
lisa_bird1	mom
KMG311	aunt
ItsRoblesPearL	man
TylerEverhart	trans
Danny_Lovell	brother
PixieDustChicks	mom
lavrenbrown	mom
SOMARog	dad
Dredd_Boy	boy
genom813	man
richardhall_art	papa
KierraMichelle9	man
MattZerler	man
_FireDread_Head	boy
susanansman	man
irisdsm	mother
CharmingStables	man
jjosephwilliams	father
JohnjayVanEs	man
Jeromical	man
ScottParksjr	father
Unicalter	man
Elev8Women	father
AligBryce	man
KristofurFox	man
MTSACCTS	trans
EmmyLou4285	mama
MelindaBrasher	man
motorbikematt	man
bhstudios01	girl
TaulibTheKiD	man
GageGoulding	man
mannyphysique	man
rubyroof	mom
mariewong	girl
Horizons93	dad
lisbetgabrielle	mother
chintankamani	man
BurtonBoy147	boy
bailey_brandel	man
Galejandro84	man
alluringwindow	man
TEAMHOLDINGCORP	man
tofireN	man
Margroc33	trans
TheMikeCrossman	man
andersoncr94	man
MorningMist	girl
tofireE	man
sammmdohhh	girl
kscheafs	father
avalonacademyuk	father
tofireS	man
RyanAbenante	man
JUNE22_	father
tofireW	man
MKing50401	father
danielfconnolly	man
TheCurryGirls	mother
NRMBristolAggie	man
KarenTranSF	trans
rayners	dad
lexcarrillo	mom
Parker1028	boy
SenseiWhitfield	man
curiouslee	dad
JenMarieMuir	girl
BML_Music	dad
tmj_pdx_manuf	man
Willbeatz_cm	man
OnTheGoOc	mom
RedMaistre	man
plaprinda	mother
Serendipity1974	mother
_DaFavored1	man
tmj_mi_hr	man
Jay_Jacobsen	man
Dr_BS	man
tmj_hou_hr	man
tgerz	man
iJasonYu	trans
sammiebearxox	mom
bbattjer	man
Hayvock	man
AllysonRogie	girl
MorgantCyrus	trans
ashasmith	man
hamblinj	man
AcquirentJobs	man
TinaBMD	mom
TransChickSF	trans
jessaygirllll	girl
reececw	father
YEYEMIGUELITA	man
BLAZADUVAL	boy
Cranmer3483	mom
rebeccaherman	mom
BenHarclerode	brother
leecoate	father
kayaregee888	girl
Abe_Froman__	father
MontserratPla	man
UFgunder	father
kbaebay	man
CurtGenesse	father
tmj_tpa_transp	trans
dexdiamond1	man
tmj_rdu_transp	trans
rafferty_drew	mom
sesaluna	girl
KelseyCrossman	man
Kichan66	man
tmj_nyc_hr	man
amandamaryperry	mom
mamamunky	mama
_totiesss	mom
catabrown58	girl
ppachecor	dad
jayneliou	man
pierrecords	man
jllmeehan	man
akaylah020208	mother
trevascot	man
bayareabeernut	man
deronhenry	dad
tmj_SD_transp	trans
SCraigPortraits	mom
tmj_wvc_transp	trans
Natarat17	girl
FHSAA	man
cassandraKGnyc	man
BillSchulhoff	dad
kirbychawkins	man
GhostArmor204	boy
JoseResendez	man
allicatcook	mom
tyyyy_boogie	man
lovelylilbird	mother
HardyBoy1964	father
CheleHank	mother
shermanelli	man
LocDocLamotte	father
DaveBatschelett	man
puppepaloma	man
PattiTheMiller	boy
TitosDuane	man
Harry_MiniumVP	father
cody_br_bush	brother
TweetV_Free	mother
jeanimurray	trans
tmj_mke_manuf	man
PrudhomCathy	mom
GettinCraftyGrl	man
jbbrookman	dad
mpmckenna8	man
dewey311	man
Senorgrubbys	boy
nattyrocberry	mom
tmj_IA_transp	trans
CrazyLegsRSC	boy
MatthewGKelly	father
jlo0312	father
clifguy	man
starvingartist4	dad
heathermeeker	mama
TripzTraxxx	man
mommityblog	mom
BlendJuiceBar_	man
xtinainthecity	mother
AlyM820	mom
nuclearwinter75	man
B_Morson	man
coolauntT	mom
Alex_Sircy	brother
RobDaCop	man
ivyLoveShop	mother
HollyThomson	mom
anabcona	dad
racep	man
pastrychef_dani	mom
hi_im_pat_s	man
CookedMeg	girl
WoahDereKid	mom
lelabells	mother
marleinepacilio	girl
TFunDaddy	dad
JennCoull	brother
photogdamon	father
JerryRoe	man
wristshot	man
jd_lewin	father
getSTACT	trans
tmj_KS_facmgmt	man
Thergam24	brother
PizzaCityFC	man
brianiannone	man
CMooreYoga	trans
CG_031	father
RickVanover	father
smhaskins	father
ryanschram	dad
UltraFitDancer	mom
He_SheEatClean	mom
SaraCVelasquez	aunt
tracimpoole	girl
ShottaHp	man
funnybrowngirl	girl
LiveWorkEatPlay	man
TEDDER2	boy
IamPNyce	man
ProfessorFox	dad
Elijah_Manley	man
LloydGreer	father
TheHillStudio	mom
sohailali	father
byronconndesign	man
chrisgeorge4	man
YazzyNas	trans
NoOneStopsGato	man
JoeCarabase	trans
GKsCustomPolish	trans
its_clarence	boy
EfficientlySimp	man
siskc53	male
djconquistador	man
doz7en	man
mwes10	dad
sltrunzo	mom
nicomdp	man
StephenFeather	father
scottaudette	mom
ReneeHikari	girl
capitalcooking	mom
benderbrosracin	brother
ranakash808	girl
MyonMuzik	mom
conniesalinas	mama
skinneygal	mother
RealEstateRuby	father
matt_yorke	man
MooglePower	boy
tresyme	man
NomadicDerek	queer
JerylMotivation	trans
sonicforever091	mama
tylerbellmon	man
LvSHEETS	man
coolassmike	father
SudoBlonde	trans
kellymoncure	trans
PSean	dad
julezbx15	boy
GisellaSamba	man
ceobillionaire	man
GarryPepper	boy
bianca_marcela	dad
iambjf	man
Farhan_C140	brother
tmj_sjc_hr	man
guiniga	dad
DreDayli	mom
abuvthefold	man
Aly_Marie05	man
Donmcnay	man
MommyWarrior	mom
BerksBeerGuys	man
tedgrafx	father
wsellers	boy
MeggieBGray	girl
tmj_mia_transp	trans
BSELLC	man
Crazyday305	girl
pastorinthehood	father
kikikeekes	gramma
FCOSENZA83	man
wersS9	man
andrerivera801	man
MuskokaSports	man
RealLeadster	man
Slapfish_2009	man
ChrisTovar47	boy
JOHN_WILLIAMS	boy
red_desertdiva	mother
tmj_RI_HR	man
BryanVoltaggio	father
paulmcrook	father
LetrasYCaminos	man
tmj_LAH_transp	trans
bacardimo	man
country_shine28	boy
herrezz	dad
GarlandGvtJobs	man
ewesten	father
everyEarthquake	man
HOODEMT_DTF	man
Myrasi	man
BrandiaDesign	trans
BIGNICKRADIO	man
AVarrecchia1	brother
dirkellis82	man
Gianna_Th3BoSS	mom
butzandbutz	brother
chambersrealtor	mom
NeueGalerieNY	man
cbg1973	father
whiteout48	girl
ministerjojomac	man
theCityMoms	mom
tmj_den_transp	trans
trirol1	dad
face_thelife	man
kbernish	mom
pamelakaranova	mom
EsheT	man
pastorrayharmon	dad
TrillGladiator2	man
ninariccimusic	girl
hobbes_ct	man
malburd	man
elvisotisc	male
BrettStolz	father
tmj_SC_facmgmt	man
marisamay2018	girl
KServiss6	dad
lindarap	trans
tmj_VAA_HR	man
KentStateEHHS	man
ICDucksFan	man
richard12982626	dad
manimimi	man
HooRayKam	dad
readasaurus_rex	man
sherrard47	girl
RE_FTL	man
BungalowLove	mom
carlodeluna	man
melsphotos	mom
jabsplethora	mom
eliz_beth	mom
colleendwilson	mother
chadbhunter	dad
EthiopianSiren	man
sephiebruns	mom
Gabb_ayeeeeee	man
angelbajana	man
MrKieranBligh	man
Ezpeciez	dad
Pucky_the_Whale	man
osophilosophico	father
GenuinelyJordan	mom
joshyhawkins	father
jesstit	girl
TehTink	mother
daaanrv	man
AEDLING	girl
BrandonCormier	father
GeorgeBBP	brother
BielBryce	man
robprather	man
Bluzanne	mother
thebenjaturtles	man
tikidaisy	girl
MadeByCustom	man
DonMeleone	boy
TeresaMcDill	mother
alinatrejo	man
emilysbishop	girl
lanamaniac	man
QuintilesCareer	man
1ad_dad	dad
osmanchavez2	man
TreyMayes	aunt
NW4RPatz	girl
steelerssuck247	father
DiversityNewsEE	man
mrmcdonald82	man
Kelsi_Schossler	man
logansaysthings	dad
robinthomas101	dad
MonaWhitee	man
tmj_rch_transp	trans
CarrieRoseG17	man
MrDeLaMont	man
damiEnbowman	man
jeromegay	father
OzzieHon88	man
MaureRx	boy
Jay_aRe_10	dad
MissCheerLegacy	sister
bremic9188	boy
TheEricFeltes	man
kaylamayyy21	girl
babypyo	mama
AndrewWerner	mom
alackofcolor623	sister
d3viljunkzombie	father
OneDapperStreet	man
itstuckermurray	mother
daringgreatly_	man
mummau55	father
TheOliviaFasano	girl
DyllieSaint	mom
johnnajanis	mom
jice50	dad
aaroncrabtree	father
cnhc1	girl
JonDAmico	man
RenP505	mom
theinsanewriter	man
krowface	father
tylerford	dad
scratchyvinyl	man
pdahlem	man
urbangeekcny	man
itsallj	man
Justina_Logozzo	man
Blessed7311	mother
Salanth	man
Follow_Ruben310	man
lietschi	man
mpbaldauf	mom
BrittanySellsLA	girl
DvmyersjrV	man
GunterMGroup	trans
tmj_NC_facmgmt	man
Livia8	girl
d56mike	dad
AnthonyPMA	man
banjodunc	man
MMLeRoy_AUSTX	mom
jeme1	man
dsesh83	dad
jwritebol	father
Supa_Muva	mom
deisydiana	mom
revpaulucc	father
alexayala22591	dad
Diy_Fashion	man
aahunterbass	trans
anjuhlee12	man
Faraiiiii	male
rharvey718	mother
ZAHAIRISMYWORLD	mother
ancsimmons	gramma
ezbreezy81	mother
djensen47	andro
Shira_SHH	dad
lrotter	man
SeanT316	father
D_Morway	mom
msrebeccalynn	mom
weareasburyCW	father
Travel_brat	man
PhillthyPhil	father
MikePJohnson	dad
BN_khalfan	mother
erniesherman	father
CajunMama	mama
micahquinn	man
dreams_and_dram	girl
veryimportant	man
YoItsAbba	man
AimeeKGunther	man
marieechev	man
evildawg	father
yankypiano	man
LizIsOnlyHuman	boy
nenetlavril	girl
EdgarGarCam	man
tangocompany	man
goolander91	girl
Mollysmi88	man
Jumbohungry	father
TammaraP	man
Dee_Aye_Bee	boy
jjpicke	man
PFritz21	boy
BernardBullen	man
DjVitorAndrade	man
SafeCandleShops	mom
benjaminakumaTM	man
Sara_Spain21	mom
tmj_bos_transp	trans
catou102	mother
sirfaunty	man
Kappa_Klassy	man
Cheer_Diva88	mother
ause7en	girl
ChristopherGary	father
alfgaraym	man
vinodiary	man
Domanyce_Da_1	man
KMannMakeup	man
CapixabaB	mother
WesDrewry	boy
tmj_den_manuf	man
TimmyBTweeting	boy
thekantastic	man
Adamgaron686	man
farmerted13	father
vickycsnyder	mom
ggltlkprtty1day	trans
kid_qik	man
Butterfly_Betty	uncle
ScratchMeUp_	boy
Alan_G_6661	man
bbulcke	man
bani_amor	queer
BTree4UT	boy
manuelgeezus	man
tmj_MS_transp	trans
HauteBody	man
thebossmartin	boy
russianswimmer	boy
Ollie_593	man
AmandaHeisey	man
aebrownesq	man
julianakerrest	man
KeepMovingTara	mother
adam_c_starr	dad
HipHop_dancerrr	father
KerrKL	father
BFostersbox	father
GenevieveGorder	mama
KarenCareyWatts	mother
DestinedNurse	mom
NightmareTN	aunt
champsuperstar	girl
GScheid	father
jmccabe72	mom
CaitlinGallogly	man
QUANNAMC	girl
debragrabow88	mama
BMUSE	man
TSBGConnect	man
CountyBoyFRIZZ	man
Itzs_Zam	dad
Str8Trippin4	dad
DjScotto	father
floridalass	girl
UWRF_BDogs	man
Nsbweatherman	man
markjbarnes77	father
Zacharycohen	man
MSkinnerEvents	girl
paulbrickman	man
hannasmiled	girl
nekathobbs_79	mom
mikegath01	father
SuperSmartAss	mother
maritesnsison	man
HopSnobbery	man
4MKSPREADLUV	man
Pamm_Romero	man
blaKbushe	girl
RDMuzik	man
Regular_Doc	trans
catmcmaster	man
thisisnelle	girl
Ronizzy	man
zoemanina	man
delphinius18	mom
AlvaroMolinaCL	man
TheRealAdvait	man
IfrahWaqar	man
rodalonso_mx	man
ifjwell	man
TrishaTinker	mama
VainBobby	father
fish0122	mother
HokieAndrea	man
thonotosassawx	man
EnriqueCampos7	brother
ariel_mandell	girl
TheJenniferDoll	man
AhmedOssamaSakr	man
Nathalia_alfer	girl
bennnssss	mom
LizNichols86	girl
highstickharry	boy
RhyneMcCormick	father
Taystockton215_	man
ledrecording	gender
GCSkiFree	man
branhamandrew	man
iRcTm	man
dnrevel	man
CeaseDays	brother
RachelErin235	girl
Brynnchapman	mother
rocketvodka	mom
RyuRabbit12	man
Jessica_Dawne	man
Boutonski_Films	boy
toastncandy	mom
laurenelizabe12	man
Pastorjamie25	father
BCDreyer	man
Bobby_Ray_Inc	man
Shoboykin	mama
ReynaRG	man
Nauckboy	boy
B43Productions	sister
gatewayaz	trans
yoyoel	man
garrettdrussell	girl
jacbejarano	man
johnremus	man
MichiganBeerGuy	dad
the_secondsm	sister
christyxcore	man
DevinNewsom	man
MleeC	girl
elyaqimnyc	man
shelleydk	mom
martyethridge	father
Mdmathias85	mother
Iceyicebaby	girl
tamaramccool	mom
brotherlovexxx	brother
RilleyJacob	man
tmj_cae_facmgmt	man
VCC_Don	man
shujon62	man
LunaLeigh111	man
ChefKav88	man
sallyhurricane	mom
sarahmmarks	girl
ottawadeafgirl	mom
MsMeeToo	man
Rev_Tim	trans
Fearsman26	man
Southinkucanmom	mom
HaggertyAaron	father
broadcastDING	father
instantkamera	father
stevericard	man
katpinke	mom
HankElliott	man
psulions	male
TiaraLaNiece	girl
VirtuallyKim	mom
BrandiWhite118	mama
BiggAdaGENERAL	boy
MiamiMazi	boy
funjerry	mom
AmandaNicoleBee	mother
hgcphoto	mom
tmj_ksk_transp	trans
LettieGooch	mom
JamieDeRosa	father
seacrzy	mom
jamesbane	man
77Expressions	man
PublicServiceTX	brother
ChicoChavez13	boy
mandymtaylor	mom
brandbogard	dad
palechick89	man
NickStreiff	man
John_Agnello	man
PiratesDontSkip	man
ReservConcierge	man
EileenFederico	mom
DondyLance101	dad
mdeeringiii	father
BrucewayneJD	man
DestinyMoniz	mama
babywarez	man
Josh_77_	man
LinkConnector	man
EliFeenan	trans
brantschulz	dad
cprwithuhstar	mom
emily_ruhl	man
robyanok	dad
kegger128	man
Sean_Peden	man
tmj_IDB_transp	trans
revbrocoach	father
brodbinecd	man
ONLY_THE_BESS	man
tmj_KYL_transp	trans
AngelaBrantRltr	girl
TommyGodlove	boy
lauramhepp	girl
33jazzygirl	girl
WYLDBOYTAZZ	boy
luissacoto	man
beverlypedigo	mother
OpaqueVisuals	dad
tjmkgray	father
PlastipakJobs	man
HtownNinjaKitty	girl
SeanEricMartin	man
tmj_bal_hr	man
adambellow	boy
notmegawattage	mother
DJhereSD	man
ethelbeagle	dad
HumaneBroward	man
EntLegal	man
NotoriousIG	man
hops	trans
DigitalWINN	father
MitchKatz	man
tmj_hou_manuf	man
KimberlyAnneW18	girl
drdavidsamadi	man
LindaSopheapSou	girl
juanca_96	man
tmj_MO_transp	trans
enriquemontano1	man
eastsidemags	man
steelersownyou	trans
NCMADulles	man
ms_devnee	mom
57sideburns	man
rlondonphoto	father
jerryrconn	andro
RobCarpenter2	father
erickiitaromero	man
caitlynhope_	father
igotthis7121	man
drewjross	girl
Djshaka09Jose	dad
_OGRell	dad
samnickmike	mom
enriqespinoza	man
tmj_usa_manuf	man
hfscolumbia	gender
1hankshaw	man
leminggg_21	girl
Spencomatic	father
robertjhen7	man
aaronGCSWF13	father
tammyh37	man
bsociale1	girl
ChefDadisi	dad
javier_saumeth	dad
BERNIEXLUNA	dad
SerpentSean	man
DJSlankman	man
bliznue	man
NERATH3	boy
EdgarCasillas	girl
andrewsmith1443	man
credd	mother
TimDuerr	man
theDOBOofCO	man
xoxoaliea	girl
PiyumalPulasthi	man
djshine	man
agirlandgluegun	girl
HeladoChris	boy
TraceyFriley	girl
ReciMontana	girl
DivoAndTheCity	boy
DAVIDROLAS	dad
pandacapricorn	male
ali_a_marafi	man
GetSaucyJacked	boy
BrandonL_Webb	man
ksmith71704	mom
AntiHeroV	man
toonpaulward	dad
FLEEBANDz_RG	boy
kt_urie	mama
EnVerdenafGin	man
Musher0123Usher	father
eenermai	girl
32JuanRamirez	man
CoachKenBarger	father
SarahEWHines	mom
Da_Franchise	boy
JordaineLG	girl
IamEricSean	man
kim_wrightinsc	mom
twoKats22	man
TheMarkRoman	dad
lolorashel	girl
brandage28	girl
IanJames007	man
barbarhow	father
MadisonOrange	girl
jrkingham1	man
sethwebster	man
skimbrel	queer
MicheleBell_NY	man
pebbyforevee	mother
Shugchic	sister
SupaDupaLuper	dad
timsegado	man
bboyhouse	boy
jengalbraith	mom
toolsley	gender
Eixha	dad
JenDorkin	mom
AntiqueDesignCt	man
KissiCouture	girl
saulfrancoz	man
tmj_nct_manuf	man
KristenH490	mom
starrprincess28	girl
KimSoMajor	dad
kjones2327	man
stacymccloud	mom
korshawilson	man
colder_bones	man
MarianaIGzz	dad
clauudiiaraae	brother
DJ007CT	man
LindaCawelti	mom
Vettpassbyfool	man
thedjgrock	father
rammtuff123	father
jaycon23	boy
aflaitz08	boy
aglezqui	man
jelynch22	man
Ms_Angel1985	mother
laurenclaiborne	mom
BackstreetXBob	father
OctobersOwn_	man
Don_lifesongcc	father
ProudDadOfEight	dad
currieka	father
anicholenelson	girl
StacyWelker	mom
vichupedia	boy
achristiangirl	mother
AIROTICLV	man
buckskinmane	man
tmj_ga_hr	man
LizaBabe	mom
WibbyBrewing	man
jessMheredia	man
joeclair	dad
coachrob16	father
riamercuri	mama
SkylerMallory	boy
tmj_lax_hr	man
DiehardDevil42	man
BluWaterDaySpa	man
danwenzel	brother
tmj_hou_transp	trans
xeokeri	father
bamatheatre	man
Lord_Coapa	man
HarkJohnny	father
NealjBrown	mom
djnabsinlab	man
murraymannn	man
aarongordon26	father
zenspacestudios	mom
LexiMcCorkle	girl
jvferg72	dad
QuiqueHags	dad
danielhadad	dad
AurEl_HA	man
JenniferMGraft	man
OrderUpChambana	man
DebbyGasperoni	mom
_MrRight4U_	man
tmj_SFO_facmgmt	man
Jmaddox31	brother
LILBUCKDALEGEND	man
PepeTheDreamer	man
IonVito	man
orca172	man
dougjusttweeted	father
itsAWOLfitness	man
PS122	man
tavco2003	father
victoriaRmusic	girl
YourFavBatman	man
selena_young2	girl
ClintonHodnett	papa
poppi7369	papa
liranoe6	man
511nyAdirondack	trans
BenFrankBrian	man
lex_indy14	girl
frostydg	father
troethgen	man
GaryCKern	man
staci_jett	girl
BobbyCaputo	mom
jehmz	man
TOMBOI301	man
skipgienapp	man
Pocahontas13th	aunt
TimBaker3	father
ayminor	girl
CourtneyMomma	mother
remixlive	man
marylynstyles	man
tmj_OKA_transp	trans
ScarletLHawk	girl
ebonyseyes	man
Beberenisse	man
andythinks22	man
Dareevo	man
JordanRGrigg	man
Pronimz	girl
liz_morse97	girl
MJP_CoachBA	man
neverfeltbetter	mother
MontyKelley76	father
DChrisGarner	father
billy_mc93	brother
AAMPRussNeibert	man
ImekaSF	mom
mrjmburch	man
DeeplyDapper	man
marcorenteriao	man
annehernandez	mom
have2bme4vr	mom
TheHulaHoopGirl	girl
asnell80921	mom
liahalonso	girl
Hop_Offutt13	mom
HeightsArts	man
BabaloBanks	man
DocHunsley	father
RealLifeKaz	man
impactitioner	trans
jamesgleventhal	dad
PaulaEdgar	mom
BADGIRLMEL3	girl
BakerHughesJobs	gender
pete_ohare	man
BrentonJohn316	father
TaraLeiEarp	man
FulanitaRivera	man
luvnbball44	mother
lebeech	man
MrsCRC2009	mom
MichaelFerrera	man
katywalstad	man
britjolley	mom
kellestransport	trans
bluearmstattoo	dad
bigjoepun	father
ChaosInHerEyes	girl
filipinabreast	man
JerodLHoward	man
deandredesign	man
amandawrate_	man
GOTTIGATOR	uncle
iembot_ddc	father
kristemichelini	mother
shadowfoxsports	man
CLADE_man	man
BeerCanDid	man
GeniaPaige	mom
CMHgayRealtor	man
thtdrummerkid21	man
warrenascherer	man
LisaCreasey	mother
drinkchik	man
montepittman	man
CostumeJinx	mother
Lita2013	dad
CasualWeaver	man
ChrisElf712	man
karrieoke	mother
ito_hernandez	man
JakeEdwards12	dad
ALEXAKAYPR	girl
RobinsonMikeD	father
KaylaMauceri	mom
IconicImages1	mom
Cody_Rogers	father
tmj_IN_transp	trans
tmj_rip_manuf	man
SanchoVanRyan	binary
bean2k78	dad
amypigliacampo	girl
sirsim	man
roslucas	father
r_turner02	man
Gen_Sandoval	man
JeffZakim	dad
irace	man
grrleigh	girl
yelpomaha	man
ElGranJuliano	father
kush_kiddd	mama
kylemaichle52	man
FedMogulCareers	man
nataliefleeman	man
511NY	trans
KatieKearney_	man
pausalcido98	girl
CrossFitEvoke	man
papalote415	papa
MimiDigital	man
PasqualeRomano	man
MikeKirkner	dad
dillonmj	dad
SteveRaze	man
LBPRO	man
naomilynne1973	mother
conniesrumbaut	mom
christinatrejo	man
JoshuaCChiles	father
JulietAngus	mom
ShelsBell	mom
pedrojcases	man
_robbiewilson	father
TracyMarini	mom
Miiicckkey	mom
GCCaywood	trans
Boss_IE	man
zboswell	trans
starcandymom	mom
kgarr	man
bradmyersotrl	dad
jlowder	dad
mrslescalleet	mother
preppybythesea	girl
thebeckster89	boy
littleviperbev	man
TanaBrewster	mom
SarahS5741	mother
ericwhoffman	man
Rafael_delamora	dad
Leonorvarela	mama
FiveTimesAugust	dad
RonnieMerrell	dad
TheTattooer	dad
Sully0913	mom
nikktaylor	sister
KimKatrinMilan	man
samanthaSV21	man
CarolynHoffmann	mother
PHILLYPHIL1979	father
SandraAvelli	girl
BrokerOntiveros	man
JHdz13	girl
thosecutebowls	man
iGotDatHBruh	boy
donkey_walloppa	man
kevthulhu	man
CapitolPR_World	man
beachbumbauman	man
DionPhit4AKing	father
thenumber244	man
DominoDeCoco	man
elyachan	girl
boomer1furry	girl
hailey_blaisee	boy
Elberttreble	man
jasonmday	father
jsloan74	father
JoeAvery_	male
LindonElementz	boy
tmj_grn_manuf	man
LaChandaDupard	mom
stoverjd	trans
BradParrack	girl
bcampbellmusic	father
harterrr	man
EmilyOldham55	man
EarwaxxSessions	man
Kikito_	girl
ZexSwain	boy
barbiimuller	man
AndreaMSherman	man
RaganRSX	dad
BlondeAmazon143	man
Miran424	mom
3girls1plate	girl
tmj_NJ_transp	trans
tmj_MIT_HR	man
tmj_chh_hr	man
timgough	trans
VinScullyTrib	man
MattQuanstrom	father
kvpmedia	man
neitaglez	man
VoteMarkSmith	man
makkaio	man
phillip_0901	father
yvonnemd815	mom
Alicia_Orozco	girl
CEOMRMONEYBAG	man
samsonvarughese	boy
MAWtravel	andro
krista_potski	boy
edmsawyer	man
Jordan51023	father
domifrancon	man
dpillie	dad
TariDawn	sister
D_C_Hernandez	father
keenerfire	man
TheSiloCenter	man
Sammy_Mitchelll	man
jenstoddart	gramma
wlukepierce	man
ModCityMom	mom
Damont_mogul	man
fishelphoto	dad
leeyahmy	girl
JesseSantoyo	father
tmj_har_hr	man
MariaGuilbault	gramma
__Jomar23	man
ASherinian	dad
Sittig00GK	man
Kayakman	trans
TheBubbaMaster	boy
Matt_Schach	man
clemchaz	man
SethFeingersh	man
CindyMKnebel	man
osfervazquez	man
reeceb_anderson	man
checomarrero	man
donlbe	dad
TavoMaxStomayor	dad
doctorstem	father
vette1266	man
mikemorrell7	man
JackRSmelser	dad
nanikai	mom
Coolnee_	brother
tamtunes	mom
McCarthy4Boston	boy
TheWHAA	man
BigSlugga_	man
imperiallover	man
TheGreenMermaid	girl
StephanieJay_UK	man
sahdsimone	man
azurechanel	man
jimlunsford	dad
BeckBeckerss	man
DisneySCruz	mom
manuel_ndah	trans
mommystory	mom
DrTerryW	man
DaxtheGinger	father
tmj_NVR_transp	trans
steveroose	man
melaniebryars	mom
bj_REDMAN	man
Marsailiquilts	mom
TaylorDestn2fly	man
iLikeDallasCash	father
bombay600	man
srheaume	father
rick_millertime	man
_nuotio_	queer
itzkelzg	mom
Roastbeefking	girl
tamrinaann	man
andre_fuqua	man
hobbit_sg	man
MsNatashaNova	girl
LynneFTCTravel	girl
KarenCita_lOvee	man
richardmelodi	man
aksalter	man
oohhdaniellee	mom
ShannonAKing	mom
SugarHustler	mom
Dollface2279	girl
JackDidinger	father
OrDiNaRy_GuY13	dad
TuftsDramaDance	man
TeamNVAuto	man
MangosCafecbus	man
DonnaLJ	man
JONATHANjokerst	dad
TheMissTarah	man
laurendorphin	mama
chloelovesyou	dad
ErnieEstrella	boy
velfre	man
JulioCesar_CV	dad
BigDogSully	mom
jeffamccauley	father
jimbolte	dad
canadiangerman	man
BigBoy	boy
aurorabaron	girl
celticsancowboy	boy
Mahoodie	mom
thehannahasanah	mother
JennReveles	girl
GoodOlMarcus	father
tcchronicles	mom
IraKimV	girl
Brittainyalaine	mom
Peggypapadatos	grandma
ArtDreamsIntl	trans
tmj_bos_manuf	man
dreem2reality	man
perhakansson	trans
nathanhoyt	man
wilbignalPhoto	man
ejwarfel	girl
ribjpy1	mom
LovOndrea	man
Jubilee_Photo	mother
aprilr96	mom
stitchesquiltin	mom
Nay_NayBaybe	mom
juliashell	mother
Pardon_MyHubris	man
vawesleyanprez	father
TonyKringstad	dad
tweetsbylance	man
FrigginLean	man
caroline_c1998	mom
DIANAFLORESMTZ	boy
XsesMag	man
Opitoc	girl
Montyql	father
LBKAEG	man
bozchron	man
LasonicLover	girl
SlickD_Ent	man
Kabir_Sehgal	man
RMCarp08	boy
Mc_Big_Sexy	man
yelpsanantonio	man
hbowles15	boy
calijulz	mom
willicia0313	father
ScottAMonroe	father
ADAMMY999	father
Prettywings_Bam	mother
1GlennWebb	man
tmj_MNS_transp	trans
cheleefrazier	girl
angconnie	mom
EmilyHSweet16	man
kieranroy	man
TRUTHorDINGERS	man
ritchie_riot	brother
ishoottv	man
KuniOnishi	father
_amandalicious	man
JIMBO__SLICE88	brother
TirtsahYisrael	man
ThatWhiteFlip	grandpa
blindheavenclan	man
Ms_TweetiePie	man
KennyKixx	dad
GuCcImIk3	boy
tmj_LA_facmgmt	man
SWTesterAZ	man
JenBellSpence	girl
INARIONE_band	man
Considerpacing	mom
tabithasierra	mom
FreddyStack	dad
Edeleonslair	girl
BronxBunnyMan	man
GantHillAssoc	man
TerinNSCS	man
rubies2redfish	mom
dannyboyec	man
BeautyandBalor	girl
DougPemberton	man
Zach_Wagner_	man
Greenswan12	man
meadowsland	father
theB0SNIAN	boy
wdevoe	dad
Scottdoestattoo	dad
awsum_mumarca	mother
bikepurselady	man
JCPskinsfan	man
larryuy	father
mistercervantes	man
MaxiGlamour	man
tmj_cao_manuf	man
tmj_OK_facmgmt	man
JackBLong	father
RobAdamsFL	father
tmj_MOJ_HR	man
AntioneJLowery	father
Fwdthinker_mx	man
bshallenberger	father
LanaMetzger	man
ChitownEmily	girl
HumanBeings1	man
JeffBlubaugh	brother
DaveHughest	man
ThisIsFRSH	boy
renegerbi	mom
fnoffagain	man
Presutto	mama
derekboy84	man
BossHaasENT	man
CloudPeakJobs	man
music_junkey	man
iamEdAce	man
icluroe	father
PaaperPlaanes	girl
IamRickybpromo	mom
shadowshamrock	mom
citygirlwedding	girl
Liz_Berumen	girl
janemitchell	mother
CDiNicolo	trans
MakoFufu	man
johnson_steed	man
cjmadrid92	man
denajoan	mama
MiriamNicoleAma	girl
theeDaveyWilly	father
MandiPughJIC	mother
CS_Just_CS	boy
NMarianoHR	man
posh_mommy	mom
lauraf229	mom
erozyskie	man
MaryGenevaNYC	man
LE_selzerself	girl
Josh_Bleeker	dad
ChristieSays	mom
RonEdmondson	dad
Dzellmer04	father
HobbsStephen	father
JoshOliver	father
MrsBruchie	man
Sdgoldies	man
PhilipMedlyn	dad
nullster	man
DannaWirthRoad	girl
DorothyOnTV	mom
kat_misskitty	mom
jestocker	man
erichof	dad
louboutinslove	girl
FaridBenmbarek	man
billymitchellgp	man
PeppaJackNBB	dad
kshevy	girl
megganwatterson	mom
AllyJenkinsDC	man
scifisportsguy	man
tmj_LAL_transp	trans
Wiz_Khaliffey	male
dancergirl201	man
saltnburnem	man
Geniusbastard	dad
FiberKevin	male
_vrg13	boy
dgniccum	boy
AJChicaBitches	boy
MarisaBilotta	man
trucnnyc	aunt
Ferny_DC	girl
tmj_ind_hr	man
Joybelles4	mom
LucysGorge	man
roberto_vpi	father
petertheleader	sister
SolvoSempra	girl
taylorcoopergol	man
CFdogfight	man
wearethestates	man
christopherokey	father
thatbuckschick	mom
KxSoftware	man
authorjlberg	mom
TheKiNGRAJ	man
urionyx	man
artistruthie	mother
Treeonuhh	man
samuelguillen1	man
TANKdaBOSS	man
IndyRob8	dad
DjNarkatta	man
ZuArroyo	mom
stephanie6943	mother
QLeeNoAsian	girl
evdorich	man
GENERALHANSEN	man
CouturEye	man
caffeined	boy
dansellsnow	man
jpmmedia	father
Getbias	trans
CinD18	dad
deedrah_w	girl
genesman71	man
brandonframe	man
Alli_Gallagher	girl
CharlesDMcCall	man
peterocc	man
LauraQDesigns	mother
HerringtonPort	man
mel_friedrich	man
BEARWULFMUSIC	man
max19738884	man
BenMulroney	father
scarnabil	man
wadeblack	trans
cozbaldwin	girl
VentureLSM	man
annavzang	boy
HookahBoyzLLC	boy
Cresco_Intl	man
bankvaultent	man
almitahein	mama
ant1379	man
Manojh_Bala	man
JeremyMoses26	brother
jodylo	mom
tmj_AL_transp	trans
dreamitrunit	man
thepieguywi	man
mooniemkw	mama
mike_melendez	man
MarkusUeberjahn	man
StressFreeKids	mom
mightyDaveMC	boy
MarilynNewberry	girl
rodynowsky	man
_FernandoVargas	man
ccorpus	man
nickmaharfilms	mom
Fabij5	mom
Dustin_Woodward	man
NCrist	man
Beaches_Beer4Me	boy
sopkooo	boy
loveholdmedown	girl
ChyanneJacobsX	man
ncolefarrell	man
mspcowboy	boy
a_rose	man
johnschwarzjr	aunt
TheScareHouse	aunt
weeziedboutique	man
collaborativeCS	trans
epc	man
The_Phantom_DJ	man
PastorGTS	father
vitalicnoise	man
MichaelJBritt	father
GloriousBE	man
jshields	father
_swork	mom
DuceOneEnt	boy
jdmccull	man
AKslimm	girl
egantony_antony	mom
D_Yazzie	father
bohoBlack	sister
JoshuaKap	dad
StarCynic	man
tmetz1226	man
HatterPomeroy	man
Sadiebay1	man
BGirLucky	girl
olalapozor1	girl
PatCorlinPhotog	mom
chickenjamwest	man
lolocha	man
JacobTiranno	man
pammasonn	girl
erinwrightson	mom
YoungNative1491	man
victor_bm1	man
KRMGtulsa	man
SarahPriceAuthr	man
abs0lutelysh0re	man
Ironman_Tempo	mom
WhatTaySaid	man
Grapelustdotcom	man
M0mma_Tee	mom
HairandLashDiva	man
tmj_nya_transp	trans
santisiri	dad
gvav21	man
RoyandJamieLee	mom
MRC_SLC	trans
tmj_las_manuf	man
leovelazquez	man
Slick_JC	brother
ImpastoMtl	father
zamngrier_	man
mrsadamtroutman	mama
OneLotus	mother
tmj_dtw_manuf	man
bbrandonking	man
mirlin35	grampa
DanBod	father
marul69	andro
Jim_SG_84	man
Cassina_Z	mom
messyepicure	boy
iknowdjlv	dad
MaryBinge	mother
LifestyleCo	man
mrspspedclass	mama
rrcrazy	man
dustyhyland	man
icebergmillz	boy
itsGABBS	boy
lizzlemynizzle	mom
DJSHANESTIEL	dad
JesseJDAPLUGGG	man
tribaltvnet	man
foxywim82	mom
gypsetgirl	girl
hmelrose	man
LewisSalgadoNYC	man
Madelinksi	man
REBNY	man
maryjohess	mom
JanetTheisen	mother
meagan_kong	girl
Dr_Billiam	mom
thecharliemike	mom
Sarah_E_English	man
evanpenn	boy
mel_alley	man
amanda2581	girl
RodneyJones26	man
kiery28	binary
TruNorthCT	man
mojoflowerchick	girl
MrMiah	man
KCWMoments	man
kitkatkapps	mom
tmj_ctg_manuf	man
WeavTOF	man
adamglove	man
SusieHawkins1	mom
DarioDallaLasta	queer
candacemread	girl
tmj_san_hr	man
MrsHillermann	mama
marciojmsilva	man
LoveLivingLocal	mom
ReedStockman	man
Royer6	father
GabrielleAnnEsq	mom
3lyssa	mom
mklavers81	uncle
Valdo1801	mom
tmj_nct_transp	trans
tmj_mia_hr	man
Caro_Lprr	gender
mbradyclark	dad
AretaChen	girl
gogorichie	trans
Cata_lara	man
kcklo63	man
MemphisBelle4	mom
millertime_918	dad
VictoriaOscari	mother
MikaelGregg	father
catie_noyes	man
PaulBurkhart_	man
rangola	man
fertelmeyster	man
BethLeahyScott	mom
secretrosenoho	man
lpickard64	man
Jess062992	girl
TheJuiceJulian	man
daenor_estel	mother
_PureBlue	girl
leaholivotti	mom
PFernandezP	man
designerbrent	father
jessicalrwash	mother
the_real_coach	father
JasmineMonet_	man
LilJimmi	mom
SirHeavyHitter	dad
tofire143	man
ronjobs_5	man
JerryHrenko	father
notgyet13	mom
Klabetts	girl
effectusfit	man
akapsychosis	man
TB_gymsocmom	mom
johnrzr	man
xtrmfisher	man
jeffstrater	man
elizabethfclark	mother
tonyfargo	male
poohbearcware	girl
Graggman	man
TaitFletcher	man
GiaBadAss	mother
FrankyCaron	man
tmj_cin_transp	trans
msdfraser	girl
Kempj1	man
chasebrock	man
scottymoon	dad
MVWerner	man
kmulkey007	girl
kungfupussy	girl
imnymphadora	girl
Andres0071	dad
lyonpride01	boy
The_11th_Letter	man
georgeagregory	father
CraftBeerFan82	father
haleypierce13	mother
FitLos	dad
karan7sethi	man
MIKEDRISCOLL	father
tmj_phl_manuf	man
MaidaNet	mom
sighnomore21	mom
ShaunaMichelle	man
callmecastro	man
cookie_comedian	mom
ZacSMartin	father
realmadcreator	man
tmj_ctg_transp	trans
swellrandy	dad
Nicole_Barrett_	mom
MChrisAltman	girl
hanshoffmanAIA	father
mariemilrod	man
dennisjansen	man
812SD	man
unikat1980	mom
arjonasintwitt	mom
BBoySik	boy
BriBDoll	mom
avonstaco	man
jasmineyu	boy
tmj_MD_facmgmt	man
purvi24	girl
cowboywerks	boy
zyll349	sister
fallenauthor76	father
statmoprod	man
BerthaBalseca	mother
AukBlues22	man
Kaylaa_Jane	girl
alexanderlund	man
HayLurone	trans
KrisNurseHero88	boy
Kirchofer	father
_TiciaTheDiva	girl
moralbeast	man
TeamSenko	boy
DaThangggg	girl
GHuffines	father
RevolutionRecov	man
FLYmusiq	man
Cyclone89	dad
godgrrl	girl
JustCarrington	father
QueenJaninex	mom
HellRellish	mother
deltagaj	man
Mooremuscle	father
nilaykaratas96	girl
JohansonJourney	mother
dizparks	boy
Tchoupitoulas89	man
scosgrove610	mom
CoachJim1024	dad
BillyHaley	dad
Lpayne08	mother
VA3DBJWeather	man
zidditamana	girl
CLharrison	mother
AmersR	mama
IpjianErin	trans
katiemeyler	girl
FranSan101	man
unimike958	dad
benator	brother
MommyKa82	man
tara_ann_lemon	girl
thisismyengland	man
ParadigmDoc	man
DionFan	dad
sonofsamurai_	man
LMHBlog	mom
djgspot	man
miss_DJ25	man
dr_rajgupta	father
victorbaloa	brother
jeneuston	girl
mkempner	father
honey_bee_berry	mom
shadows_reality	mom
tmj_oh_hr	man
SaraEM22	girl
Magali_TIFF	man
jazzzmain	mom
diberri	dad
suarezdanisa	mother
tmj_MI_facmgmt	man
LoLoLorine3	mother
simonereyes	uncle
ABobbe	mother
carissa	mother
KristatheOT	man
Sar_8686	man
janicebaldwinkw	mother
MonaBita	man
VEGAS_KID_777	man
CH33R5	dad
696bdb830cad412	mother
2pleasant	man
LatinboxSports	man
DocPayne24	father
LindseyOliphant	man
CarlyRosich	girl
THMTT	man
marianobula	man
flygirl_Frenchy	girl
garydginn	father
alexsdelis	man
RashanThompson	man
A_F_Augello	man
arleana88	boy
tmj_nya_manuf	man
timmymyers2	boy
doaas	girl
MichaelGCrate	man
paola_kowalke	mom
sugar_brand	girl
Kulayde	boy
joreyj	man
Tycho77	dad
phlowen	dad
tmj_NY_transp	trans
Matschmomma	mama
Megz_MN	boy
socalnativefemm	mom
alexisjaaaaaay	mom
dhasty01	boy
tmj_FLF_transp	trans
summercornelius	man
MsLtotheJ	mom
portoflongbeach	trans
xMALLORYYOUNGx	girl
VTB1	man
RaquelChristine	mom
iislandbreeze25	mother
K8lynJo	man
thompsos3	girl
petefordoral	man
tmj_NE_transp	trans
alyssastrongarm	mom
EspositoFilm	man
IHMCO	man
joygarnett	father
JayVig	man
_nicdanger	boy
guslimousin	man
tmj_tol_manuf	man
maryrutherford	mom
HelloMissComo	man
kalvinklaus	man
HeyKyron	boy
itsalovethang	father
samuraihawk	man
misscarriemae	girl
jewelchainz	man
Carlo5RV	brother
TommyBlackML	father
tmj_stl_transp	trans
TaraLeigh50	trans
Luuuuiii_V	man
DanDelmar	man
otaviodaniel_	dad
tongawear	trans
Brianne_barry	mama
JoelRobertsExp	man
IamATHENAS	man
Chatonsworld	mom
tmj_buf_manuf	man
AbbyEmpire	mom
sarahcolligan	girl
jmeblume	mom
allie6126	girl
itsashlaw	mom
okiebritt	mother
MarcoMenesess	man
JonKernPA	man
CasaMeily	boy
365DaysofSport	man
HersheyBlakk	boy
ghctim	dad
JohnWusah	man
REMAXEvolution	man
starlitediner	girl
eheindell	mom
jclee89	dad
JamesDavisson	man
nickki_lew	boy
Healingmama85	mom
Barlowe500	man
prettytallchron	mama
Liz_Cerezo	mom
evega0	man
jillmansfield	mother
joeyinpink	girl
GingerBeerdMan	girl
SGH_Jackie	man
tmj_lax_manuf	man
CAprilWallace	mom
RaulCruz_SC	man
MsShoptaw	mother
AbePh31011	dad
BigPapi241	father
VisionRx7	man
berryandcompany	girl
mamajessof3	mom
jerseygirlnb	mom
kelleyaus	mom
dee_x2	mama
tmj_WV_facmgmt	man
SweetLilYou	mom
LeBeautyRoom	girl
tmj_FL_transp	trans
KenMoire	man
HeyMamaTeas	mom
McGeebari	boy
DuaneAnders	father
jeniaggie	mom
harvardx	dad
tmj_buf_hr	man
JanieGPhoto	mom
BNapikul	man
NickoleLM	boy
atxbikegirl	girl
HigherBeatss	man
eelain212	mom
melissa98502604	mother
LifesizeLuxury	man
pastorP2	father
luvcherripye	girl
AMFilomena	man
MFU_Kiss_My_Abs	man
sweettartgrl	mother
ginarachelle	mama
Vick_Ramcharran	man
DJSpynfo	man
Premaire	man
_amaraisis	queer
JohnnieBud	mom
CharmedOne1	mom
JukiEThakiDd	man
silran666	trans
PaulAlsides	dad
emtooicy	mom
jaywashradio	man
sprank2360	boy
chantalboyajian	boy
hollyloooyah	dad
Sincerely_Yuli	man
mssjr139	man
KaitlynElyse1	man
viricm89	mom
Real7iMe	man
threehautemamas	mama
RozayHypingServ	uncle
NYmovieGIRL	girl
tmj_NH_transp	trans
Alexis_MR	man
kinkykrvykrafty	girl
lib22	mom
socwatchman	man
natalie1202	man
hotdogsssss	girl
bamabennel	man
Gpalestino	man
lindsaylandman	mom
ItsMeChasity	girl
robcal25	boy
notcupgirl	girl
CRob7	father
condo29	man
Kvpendergast	man
emmaspatz	girl
paulwelshie	man
NODSOLDIERGIRL	man
Isaiah_Entre	man
BranninWGL	boy
maxbarta	man
cupcakeshells	mom
kiasuchick	man
johnnytice	boy
weysmiley2008	mother
InkQueen33	aunt
WebVixn	man
ChrisMaragakis	man
AccidentalSoul	man
travistoy	dad
HawkeyeMonet	mom
ogsnipe	man
babyfacechulo	girl
alisonnyu	man
Beautrotting	brother
AboVirBoj	man
JMFans4Ever	mother
PattyPyaconis	man
jennilind	girl
HolyCraft	mom
dustinbennett76	boy
mandatecat	man
tmj_IAC_transp	trans
joegreenethe3rd	papa
SuperiorMovie	boy
micberryman	man
HooverBoy85	girl
kaylaparker	man
JohnBranchNYT	boy
morgan_quimper	man
BritneyCHAPSTIX	girl
naninn	man
ryandwest	mother
sjohaze	sister
jduvlaris	mom
Mus1cHead	man
christellar	man
MexCarey	father
KimCoulter3	mom
mollyjamesgolf	mom
courteroy	mom
tmj_GA_facmgmt	man
iwantsomem0	girl
LimaJacketsfan	father
becca_kennedy	man
PuckerBeautiful	mother
djfresh205	man
FatFreeQueen	mother
fitzj	girl
andyundo	man
AshleyENorton	man
Sarah_Ocea	man
HannahLeigh4AU	mother
Riley_Blake	man
DriveW1	man
buzzbrockway	father
annettelchen	man
valery_lorenz	girl
TheMuseCrypt	trans
MsKarenWilson	man
psa2	man
cathynormanindy	man
alexisthorpe	mom
HomamadeFromThe	mom
mudhuney	mother
JTromblyNH	father
puckchk	trans
Mcgavocklibrary	mother
adamparrilli	man
amandaleighme	man
tmj_CO_HR	man
ShannonD10	mom
joedaddezio	man
AmericanBankCtr	man
ryanjsimmons	girl
GreatJobSeth	man
diegoLandero	man
Preston_JamesIV	man
wilksart	dad
TransUnion_Jobs	trans
BridgetownBS	boy
brokerEXCLUSIVE	man
FLIRTcomm	man
bterrisphoto	boy
capriciousLEO	man
NicoleRoyseArt	mama
bReedify	man
birddogg37	father
EdwardOZ	man
Morgan_Shaffer	girl
dvilgatell	girl
tmj_usa_facmgmt	man
MissHQ	man
spinningblue	girl
MRGradillas	father
evaconnors	mom
KidPink88	man
lacremadetuoreo	dad
sammyealix	father
UVnots	mother
HollywoodOompa	man
BasciuCristiano	boy
JustinD_King	father
willwalkermusic	father
FaridXan	man
XtremeLivingGym	father
L_Y3T	boy
tmj_ca_manuf	man
club425	girl
RealHerremannen	man
celeste2102	aunt
inthelooptv	girl
naoki909	man
InkFloyd	mom
iam_vashtiQueen	father
FiveFootPhotog	mom
Jessi4JC	queer
Luh_Nay_Nay	mom
suzannasdream	mama
OctavioRegalado	dad
AdrienneEC	man
HendersonR	man
nikkiaraguz	trans
scoularcareers	man
BillieWhouse	man
MorganFabulous	man
emich	andro
JebMastandrea	girl
gregoryehodge	trans
spencerordonez	man
LindsayMMichael	man
nick__fit	man
thegilby	man
BoBoyLB	boy
msmoozy	mom
KrypNotiq	man
TraiDaniel	man
JoshuaNink	dad
opprecht	man
Hector_axm	boy
billyhoffmanpga	father
shapeurphysique	trans
momsharonb	mom
kcbusymom	mom
gherman222	man
ausstinnotexas	uncle
ccgibbs	man
Sup3rchubb	man
TrishPTrout	mom
thoughtsyoustol	girl
david4holman	boy
ChaChaProds	mom
cindyvirden	mother
NadReyRo	man
tvrivnna	girl
YiddishSteel	man
tmj_chi_hr	man
dantes0814	boy
solemnerin	man
TracyOClair	mom
djdachef	aunt
AlecSmith7589	brother
tmj_tpa_hr	man
BBetsy	man
chrisclonch	man
iBenEvans	man
dodson	dad
jlondagin	man
tdellac	mom
CapayMills	dad
eaglefootsevenz	father
lilliezi	man
MamaKByrd	mom
m4nduh	man
basest	father
Van_Dessel	man
zak_adams	father
vermeerjobs	man
jdreynolds3	mom
ValueHelp	father
theSupremeJacob	man
carlosvigil	dad
WundermanDC	man
PLRofCT	man
biggiertzy14	girl
rocket_kal	boy
TheNicholasSnow	man
suavelyons	girl
MANTUSANCHORS	man
ladidapilates	mom
JasonMcc77	man
engoogy	man
heveweight215	man
tedafferback	man
sfortnum	father
ktvermi	mother
lovenkotb4life9	sister
bluvsthaladies	girl
CrabbyVegan	trans
jukeboxsween	man
nicole_wyen	man
FlyGirlInventor	girl
JoeDRobinson4	dad
__sheashea_	girl
carolyncburgess	mother
mermicornhair	fluid
Kelli_Gunnells	mother
minaabaaby	girl
raulradio	man
daycogs	mom
MVMNT365	father
mama2da3rd	mom
Ben_Adelson	man
LoganEleven	father
DominiqueDuque	mom
aquanetta71	mom
Huitzi1	dad
GayCapeMan	man
alanskyo	dad
cwatson30	man
SpydermanReady2	man
EwillzMusic	man
carter_realtor	father
pezliz	boy
hellokittywuvr2	girl
ChrisMidtownMMA	father
Hustlermama	girl
mamasita6752	man
TRInTRIagain	man
SforScorpio	trans
AJ_Janssen	man
Buddhakai13	man
DJ_2377	girl
astroboyzmusic	boy
thingsweheart	girl
jurczyk_peter	mother
RAULTS	man
SirrBanks	father
lamadrid_alfred	man
jpenico	dad
NYTupelo7	mom
Dingman21	man
rgodschild	boy
payolalala	man
KeleighBrockman	man
alexandraizzo	man
bigdavem1967	father
demisDINOS	man
AliasJonP	mom
MityMo	mom
okmogwai	man
CazandraPerez	mama
GhostTownCR	man
tmj_atl_prod	man
Victorymartial	man
DiarmaidMurtagh	man
starlitsound	boy
JOJISMX	dad
kanditom	mother
MarvinBlumer82	brother
LadyAlchemy33	man
MsIvarsson	mother
mikeperpich	dad
TheRealCupofJoe	dad
parkdave	man
VIAndujar	man
aprilpate	mom
Romiah	mom
jamiebuckner	boy
Kazerie625	man
boredgirl260	girl
Theillestbrotha	man
_BlueEyesss	mother
richblumer	father
yelpatlanta	man
hillaryboucher	mom
XtalGrrl	mother
tmj_CT_facmgmt	man
makjacobs	man
Josie_Feliciano	mom
JeffMilesY100	dad
hazelebaby	girl
meganswage	trans
warrentedd	man
nicholas_wray	man
FrKeithC	man
MichaelEBrown	man
tmj_MIN_transp	trans
PastorChrisTeis	dad
jpalfrey	man
HenriFrankGroup	man
dingosdogsittin	man
MACK_GOD	man
SaySoManman	brother
lauraalbouy	man
MrsCalabash81	sister
FemmePolitique	girl
tmj_bhm_transp	trans
MeKiRoMoHamm	girl
faith_laurenn	mom
Bracci	man
BrendaM_Yoga	mom
AdamWolf77	dad
tmj_lax_transp	trans
seashellssitups	mama
drawdrew	boy
PinkBBWhiskey	man
4feetOfBrill	girl
sirens_calling	mom
lesliebruceamin	mama
MissCassidyRose	man
brittweckesser	trans
KatOfAllTradez	mama
slickboydanny	girl
APCaddy	mom
iStReEtWaLkeR	boy
HobbyLobbyJobs	man
Mosesjp	man
daniellexpowell	papa
Devour_Brewing	boy
ExecutiveMgmt	man
angeltolbert	boy
lukeschantz	man
MargieMbk	girl
NsDvalt	mother
Changfilms	dad
rickscar21	dad
malisa_phillips	mom
DRE3K	man
JMAC_2017	man
ELKunkel	mom
MeylinRodriguez	man
rfreuden	dad
TheRiverRatsAVL	trans
MKSTWRTINC	man
PRINCESS_KITTIY	man
PaulCesarSEM	man
twware60	mother
jakeybro	dad
giftieapp	man
mearzie	man
TheSaurus831	father
CoachSethAdam3	man
Pixie_Dreamer	girl
morgan_cruce	mom
RobWillsea	father
itsvictoriaeve	girl
daniellee721	man
amsclafani	uncle
CristinaTularak	mom
StephanieFred11	mother
agirlandacamera	girl
wosby	father
MrRayFit	man
kaitlynlisella	man
the_murdoctor	man
mslorenmackenz	girl
Brett_Swain16	brother
_mexii40	father
_JS4	man
stevepic1	man
tmj_jax_manuf	man
TWiG	dad
mostflogged	man
Wigstessbeauty	man
deanokat	father
abirchakMMA	man
PhebesNYC	sister
ThatKazin	man
emilyscoby	mother
stephenrockwell	father
GenaKirby	mother
TabooRVA	girl
Track_QueenB	girl
Delrokz	mother
sandybeachgirl	man
amberrenee	mom
lesterplatt	man
jclgaines	father
highdration	man
jakendaxter	man
mrtnzchrtll	man
Nicole2U_89	mother
andrewjlovesyou	father
ili2828	man
SmakkDaddyTC	man
PEGGSTARR	mama
ChiqueDThomas	man
Wild_Bill74	father
goHarDTweets	man
WelfareWaster	man
Qerry1983	man
ChadPSG	father
nikkacyfootwear	gender
ElizaWitherow	man
RosaryAurora	sister
julia_c_ryan	mother
LittleSuperCam	father
deenasays	mother
listentosound	man
AliciaDiMichele	mom
PROFFTV	man
AdamTrentMagic	boy
GingerDodds	man
JohnnyFieldgoal	father
timothybroder	boy
michellsanchezq	man
moelabNYC	man
JeniSummers7	boy
Knitcircus	mom
miamigorgeous	mom
TootsieGuevara	mother
MsNicola	mom
twilyman	man
debililly	mother
TooTallTray	man
BamagirlRUNS	girl
revjmcguire	father
offcast	man
Brian1OHara	man
RescueTrenton	trans
SilvermanSBG	man
McBenefit	man
Andrew_S_Heuer	man
JRTappenden	man
Lebeok	father
PearleneUtley	mama
_Whit_B	man
Tammie4Change	mom
AmyPredsfan	girl
Roiju_	man
SGalantee	mom
justinimmel	man
sdmike	father
drippyniem	man
jess2973	girl
radonutrition	man
BootlegKev	boy
MaserB47	dad
WeAreDaRookiez	man
JeannetteKaplun	mom
Nina__Nichelle	man
ericabenham	boy
TUMCYouth	man
dorydorydory	mom
kateeb1	man
TamJohnson21	mom
B_Rock22	man
RedDirtBiz	papa
drnatebell	father
ThatsAHotMess1	mom
YongeJaffy	man
EatDrinkChig	father
rimij405	man
BattyGirl	man
mark_munoz	man
JuicePlusSharon	mom
jonnydtyler	father
juliannegabert	girl
checkyourDgo	man
lyssaleigh718	boy
TheBroApp	man
BUlincy	male
cplater	dad
RoyieLouis	man
beatrizbearztti	man
TinaHui	mom
_megansavannah	dad
margiewarrell	gender
damerowe	boy
rice2mo	man
tmj_mke_transp	trans
BuyHomeTown	father
claudiafp_16	girl
sportsreach11	father
JOEKINGRADIO1	man
iRock_Christ	man
ItsTheirWay	mom
miacupcake	mom
tmj_cob_manuf	man
tmj_ms_hr	man
dakotamweiss	mama
tmj_PA_transp	trans
Adam_On_Tap	man
lkoch13	father
coobs	dad
CloudopolisEnt	man
HAZMATTALKBOX	mom
mikescheuchzer	father
LizzieK8	mom
unklar	dad
tmj_elp_transp	trans
ChrisDiller11	dad
kellerdinan	man
fletchthemonkey	man
tahu508	man
imlovedbyGrace	mom
woodmanzhouse	man
elfrankx	man
thisonegypsy	man
IndigoHandloom	man
lizzytishrose	girl
kassyy_g	mom
milehighsoapbox	father
_FelixM_Mojica	man
tmj_KY_transp	trans
emily_gadz	dad
Dannigirl06	mom
melgrunow	mother
jhnmchl	girl
IndigenousSlay	man
rachaelyaeger	man
DaveEast	man
The_BeardedGent	man
LL_FOOL_J	man
PardonMyFrench	dad
DjAnthonyRey	andro
KristyBChicago	boy
iamK_West	father
trhops	mother
jackiebateman	girl
cortneyssargent	father
JoeMoreno	man
howell_i_roll	man
jenbellor	man
AZStormTracker	man
foseloman	man
LeChiMo	man
ThunderTie	boy
MelissaHebert	mom
BDAP54	brother
andresireck	man
Elleeeesa	girl
Sindee_Savage	mom
THESTYLEGUYDE	male
tmj_sdf_transp	trans
EditorRachel	man
laurenflanagan	girl
redbaronsn	man
WIGeekMom	mom
wagnerlk	trans
JohnmRitch	dad
skyway1972	father
SLLIMSKRILLA	man
amandaalzaim	mama
Jen_Coughlin	trans
rockytop26	man
MarnieBelle	man
toddstringer	dad
chromaticphoto	mama
CJLuzi	boy
BeverLuLu	papa
Donquanetta	man
YoYoDC	dad
SpelmanAdmiss	man
Citalfort	man
shanreed710	mom
rodthechiro	father
southernbride	girl
IsaacbSanchez	man
edrewworship	father
emkelly	aunt
alexgq28	mom
TinyRager	mom
zachyosh	man
VeroChacin	man
lrc2009	mom
Xianman04	father
danicardxo	girl
TroyGates	man
juancblue	man
MikeKoslap	man
TyNitty411	mom
maxleitner	man
EastsideEazyPME	girl
martinltorres	man
tmj_atl_facmgmt	man
pixleah	mother
JackieLewyckyj	man
F3_Zima	father
AucetVerum	man
emma_ramosramos	sister
SarahHart	mom
elysecanfield	girl
Christina32828	mother
ozweaver1	man
torilcarney	girl
ShannSullivan3	trans
brittanylayne27	girl
e331791cad934b2	man
_bigpops	father
ItsRickyyDoee	man
fleurdevie	girl
Yosoytole	dad
stm555	father
CarrieLippert13	mom
RaeganPerry	boy
Mr_Westside	boy
Bifflawson	man
WORLDSFINEST200	man
billiondollarow	man
fuck_pop	boy
PersonalChefLPD	girl
TadBraner	dad
Kingdog48	boy
FrankHoness	dad
divaofwealth	man
damoncampbell	man
DanHitman	man
dennisAsmith	man
rachaelsage	mom
DevonSchreiner	man
KayleighMWilson	mother
Rpkincer	dad
rett_music	man
drcpherrera	trans
TeamFuse2015	father
koreansooner	father
goturwhipp	man
kk_hugs	girl
PaulCantor	brother
bradimirputin	boy
dmoneyspartan	trans
LuisCGreer	brother
AbelMisael	man
getch_a_sketch	man
leighanneweiss	mom
shrimpfriesyo	girl
HBAchieves	girl
tmj_clt_hr	man
rocco	man
daviddriveway	man
OzLady41563	mother
paigetimer	mom
PhilippeDesra	man
ChrisSurratt	man
sfhowell85	man
AngeloTRobinson	father
starnold4	man
Cammiluna	girl
GlobalVisualGrp	man
snemerov	man
midtownlunchLA	man
jeffmart22	man
KisforKechell	girl
Slightly_Frosty	brother
conorlyne	man
CoachJam00	man
leahshafer1	mother
edsker1	father
ManduhLynne	girl
candy156sweet	girl
Climb_This_Hill	man
Rebk_ojeda	man
Rose198172	queer
cpizzi	brother
rockyo23	mother
FHChinaski	dad
GabrielaWndrlst	girl
MantaRaymarc	man
10KSBNewOrleans	man
Only1ConnieT	girl
JaskaranDhanoa	man
Chuismx	girl
QuaintRevolt	girl
AndrewMetzgar	male
Mariahhrauf	girl
FaithFitMommy	mother
PullmanStandard	man
jodyforehand	father
tmj_sac_hr	man
HughVail	man
J_Mothershed	mother
robbotxwalker	dad
thesilkroadrest	man
Shanedluhmann	man
trevlynthevoice	man
JustinCaryDP	father
GreenPlateLisa	mom
tmj_dc_transp	trans
dsimpso1	father
michelleskirt	girl
JohnnyRowlett	male
LetsGoJames	father
Inkkbully	brother
Billboard4Jesus	father
judgep15	brother
mufasa2b	mom
ktinacockerill	mom
945SportsBeat	man
Goal__Digga	man
emily_jude923	girl
SaraSohrPreston	mom
ROBINBANKS	man
rhondawilson05	mom
kateheadley	mom
GothamNY	andro
henri_ng	man
Adri_Williamson	mom
tmj_phl_hr	man
STANDAMANBKNY	man
SwankPR	man
CarolineArey	mama
McGiffinTim	man
JaceEverett	girl
Jesi_Jess13	girl
lauratherad	mom
ManhattanTwist	man
NicoleTrumps	mom
jpupnorth	father
mariaspov	man
FlameGoddessLee	mom
dmrson	man
tmj_OH_transp	trans
amybrands	mom
tmj_slc_manuf	man
beejpowers	dad
dianaseeley	mom
agus_schwartz	dad
tonyhamm619	man
DKYspring	father
TammyDavisPhoto	mother
DadtoGO	dad
rafgete	dad
KenyattaR2M	man
TEISBE	boy
__AJBADASS	man
AlanStump1	brother
janinaleedelrio	mom
Klyrik	man
MrSwicktastic	man
gomehead2000	father
Harsh_Voice	man
mosspike	boy
CSmalls	father
vismer	dad
aslaughter	mom
jbb5359	girl
Leahohse	mom
amanixyasin	man
michaeljknowles	man
PaulinaBustosA	dad
yingnyangym	sister
PureBarreFrank	trans
chef_vigo	dad
lnrbailey	man
RaikenDestiny	girl
ianxcarlos	man
philipMANZANO	man
misskorielee	boy
tmj_lah_manuf	man
inGENEusPR	man
He_Fr3akyAhHell	man
jessikill	trans
jeffcrandall	dad
SportsByMooch	man
CFKidsBones	mother
BrianJB85	man
DBaugh25	man
djfatboy1984	boy
sorealcupcake	dad
HaleyRhiannon23	man
alexadamato	mom
MackenSays	boy
raulmerom	dad
jacipena	man
MeganJRichard	mom
kimhollenshead	girl
kizahada	mother
JessieSchiefer	girl
BentleyRealTalk	trans
activemom4life	mother
FatimaDaz2	man
densy3000	man
katie_uske	man
que_sara	mother
persiarestauran	man
BigMoneyRog	dad
AlzateJulia	trans
GreekMike1337	man
habsdreamer	girl
mhardy770	man
Romantsunami_67	boy
seemichelleharo	girl
tacosnyder	mom
Valerie_Hoff	mom
tmj_abq_manuf	man
kaliyan	sister
TravChina	man
jeffngail	father
Pacheco9_Julio	man
TheRealJeffy	man
dreaminsight	man
mikejny	dad
justneenaa	boy
chopsdapoet	man
ArchitectingQue	man
mrevil310	man
tmj_ctn_transp	trans
goldroom	man
Davidius	man
walterrrr	boy
thisismeOhana	sister
Axtulsa	man
Clautayita	man
LukesBeard	man
enLIGHTenedCIG	man
Hariatmabirth	mother
PKGOTYA	dad
__StackZz__	grandma
jrosborough3	man
okhateeeb	man
Aleptz	dad
impromptubeads	mother
eastersfanci	girl
LaurieAAmagan	man
lisanapoli	man
VegasMakeupMan	man
DevouringJax	father
luzherrera22	mom
CoachKAdkins	father
KellyStrait	mom
theunabeefer	boy
alwaysaware72	mom
YankeeQueen69	mom
AccuWxBeck	man
NickAck	father
HmaeH88	girl
nickilenk	man
justin_beachy	man
MissMotorMouth	girl
danielhuman	dad
comeuppence	father
ChubakonPeludon	dad
sryimnotsorry1	mom
Msjenniferlong	man
MIKESWIFT	dad
GrantHiura	man
Hassenstab	boy
stephkornblum	girl
BoutiquesU_CW	man
realPatCendes	man
innocent73	man
ChefJohnny	man
Anneth_Him	man
gneere	mom
koldtrans	trans
edsonsrdz	mom
KatWildish	man
nursepez	mom
Jebet221	mom
jademeneguel	mom
xtrememeasure	man
TyrellRockstarr	mom
jenniferlanser	man
MaryLordDC	mom
TravelWedding	man
tmj_ksw_transp	trans
HisaysMark	man
mitchellforbes	man
urielac	man
guccigirl1977	mom
ShopMint	man
jaclynkellye	mom
triphonkyle	man
JoeNoorth	dad
jennywoodruff	mom
bigbeq12	man
hollywood_01	male
ArtSalcedoFC	father
sara_stanger	man
DBDVegas	man
cmmama10	mom
DjOnTarget	father
Plasmapie	man
adriianap	dad
yellowscarfmom	mom
joelhwilliams	father
doulosbygrace	father
gsizemore28	boy
raygallardo11	man
camila_s77	mother
ElizBudlong	girl
ccnb0809	girl
chrisgross73	father
TheYumDiary	man
Katie_VanVeghel	man
calliewyne	mom
JP4DFit	father
Malpractice24	boy
klvnhrpr	man
BigCzo	father
tmj_MT_transp	trans
djexpression500	man
Showcase_Studio	man
mrkvm	dad
AKAemily	girl
tmj_kan_manuf	man
JillCouri	mom
robkahl	man
rayhorvath	dad
labrisaphoto	brother
duby78947	father
tuuee2	boy
bitsandblooms	sister
Mistersmoker	man
DrMarkBratton	man
BaguioMyrtle	mom
NatalieTPitcher	mom
nbarake	man
AcademyRecords	man
SwageNYC	man
HUViolet	mother
vielkaveronica	mom
xdeliriumx	father
AZRChow	mom
MistressKofOs	man
pink696	man
MIKEALIS	man
BacchusWineMB	man
JJHokie	mom
elisabethjlane	man
CourtneyClayton	man
chrisfitzh2o	man
JeanneLClayton	mom
tmj_atl_transp	trans
UTdannyc	man
jenniferlilya	man
ioa92	man
msquire03	dad
giftbuzzing	man
AdamLabo	dad
tuffigirl	girl
The_AF_gay	man
amberlatelyblog	mom
markoleptic	man
BrodyLee8	boy
sona_c	mom
hughweber	dad
wsdpc	man
samanthaditzel	trans
FASTENTERPRISES	man
hserody	mom
GisselleReyes	dad
tampamom	mom
thyme4cocktails	girl
jpkristal	man
ListWithKim	mom
TrailsH	father
AriSethCohen	boy
jmwood11	boy
WilhelmtheDog	man
BrianBantButler	brother
MorganFogarty	mom
rirytyrell	trans
FRANTICent	man
RAlejandro3	man
peyta	man
emprxncess	girl
ChrisPartin	dad
MattLeddy77	man
chainfury	girl
aidanrv	man
LiasLyfe	mom
jkru	mama
marielawtf	mother
Navarro_0598	man
luis3etancourt	man
biancalr7	man
MikeSwing	brother
nellytrey	boy
KevinJJuliano	boy
MissVeganKylie	mom
LibrarianMsG	mom
blingblao76	man
williamkovel	man
The_Amanda_Moya	mom
E8SilvaL	man
lvcaswiman	man
denimfuckmeup	girl
OMMASDOTCOM	man
MarcisBakery	mom
realhighfemme	queer
caraduchesne	mother
clay_rehm	man
yasi39	girl
AnnieGreaney	man
MichelleCastady	mom
soopersized	man
SpaceInVayda	girl
Cindyjael	man
jmcbain	father
Nicki_Rachael	aunt
FortyWeeksLater	dad
JennaMBoyd	boy
DSly	man
zorrosgal	aunt
OneEyedDoll	man
DaytonArt	man
gameusedguru	father
markstockslager	man
JorgeDHF	father
dannamariet	mama
NelsonLonny	mom
JoshGellers	man
HAV0C1	man
SexWithDrJess	boy
sarah_cyoung	uncle
OzkarNDallas	mom
DsPchiscake	man
YelpLouisville	man
scavengerstreas	man
Blissology	trans
Tonyahuqt03	girl
livvymgodden	mom
ElliottAntal	man
AGallagherRDN	trans
lmondayglam	man
ajschwab	father
DJSoleHeaven	man
JonathanNBCLA	man
merbear121	girl
JesseDLane	dad
AmarilloVanGogh	dad
Irishchef910	dad
msprairierose	man
heermancefarm	man
GONSZO	man
julietteriette	mom
alecdakappz	uncle
jfaagency	man
joelle_iovine	boy
CodaBarBoston	mother
marshcooke	man
tmj_ga_manuf	man
Moonlight_RN	girl
Dragon_Man_Inc	man
RonFGarcia	man
BarryPoole	trans
georgechuck	father
eswarden	man
cshawnna	girl
tmj_atl_hr	man
amysullymusic	mother
dirtyboogie	dad
DJJOECATDADDY	dad
bigrichoutdoors	father
DeepThghts	man
3ni_wan	dad
vbace18	mom
kb_dunford	man
MrsARodriguez	mom
mattmoreno	man
cschuler1994	man
regina0216	girl
JohnRGSO	man
barkermama	mom
DXRide	man
RKrumhansl	mom
JermaineHorton	father
gholleyjr	dad
bpmarkowitz	man
KayyylaMaeee	sister
hjancoski	mom
DamiOyedele	man
druggedzebra	man
DavidReevers	man
JamesG_MGMT	man
sarahgoooodrich	man
bradduryea	boy
Teresa3817	girl
JAMESHHUNTER	man
g1totherescue	man
monicareidphoto	mom
shopjinny	trans
drredfp	mom
shanesparks89	brother
sarahwells87	man
mccauley82	man
stevengmorris	dad
joemurguia	man
amanda_meyer	man
AmericanAmb	trans
juanpdesantis	man
mattheinricy	father
HeadRush_Ent	father
TBStaffing	man
deniseiz	man
suelemgisela	mom
MiaSferra	mom
gigs412	man
barberfromNYC	man
Zyun_Mommy	man
ErnieOnTV	man
ClemsonKelly1	mom
Matt_Montana	dad
thisiskyro	man
therealjshields	man
pissyopants1	father
beacatalystnow	father
cyriljones	father
JenOni_Inc	girl
tmj_mob_transp	trans
WorkAtRoush	man
donilon	man
chuchin_almanza	dad
andreaequisx	man
revolvergroup	man
SashaMarieStone	man
andjelinafox	dad
MotherandEarth	mother
chefkevinpenner	man
Paola_Chavez	man
Rmrstarpat	man
Puga403	boy
d0b0	man
caitlindeters	man
HGarciaFoto	man
kcolddog	man
BReutebuch	girl
Jenny_alonso23	man
seriouzstan	aunt
xxkeepsmile	man
TheGingerPat	man
CAPPTAZ	man
tmj_msp_transp	trans
MatteiBookBits	mom
DaddyRolo	dad
Bez_Rengifo	man
HaleyAlmond	male
AngelaOrganizes	man
boiler_sport	man
djscoutmaster	father
GoldGlover2B	man
justyspin	queer
REAL__AG	father
mikewardian	father
tmj_RAM_manuf	man
CathyPaper	mom
aileenabella	mom
gregmanity	trans
Lumpyokc	dad
tmoore94	man
ale_fabila	man
ckhiatt	girl
thewinecoach	girl
ANTONIOXTASY	male
LaurenVamp	man
djColorTV	man
LaurenLeonelli	girl
alliieethefall	boy
abrahampinto	man
MadeInCanada_13	man
michel_josie	man
STG228	man
therawdoctor	mother
TheMomNoms	mom
Erika_Godfrey	girl
timhorvath	girl
JustinTotino	boy
ilevelcontracts	man
Pawkiwi	girl
ksosa14	mom
MiguelMonteroo	man
Aniya_PinnJeff	mother
PaulGrist10X	father
grahamhooten	man
LexiKubrak	girl
PastorMikeKirby	dad
RONiTORiVERO	man
4BillLewis	dad
MzShay2010	girl
CompactDiva	girl
alelluch	dad
danigarcl	dad
therealallotey	mom
ImSaraKing	mom
tmj_stl_hr	man
karichardsbrown	mom
montano	man
Pastorglesne	father
tmj_sjc_transp	trans
33_andy	man
Sambam2828	dad
seymourskaterat	man
ChefMarySonnier	mother
MauriHCamacho	father
fultonhere	mother
sd	andro
goferrarif1	man
baby_jhyza24	man
ThatJaceRoberts	man
attorneylarson	trans
emgeedub	man
martinimandate	man
endrommare	girl
DrRomie	man
LauriRz	man
ABruinGirl	man
Pampiress11	mom
alyssamweaver_	girl
LauraK483	man
tmj_OK_HR	man
MyNameIsZsack	girl
S_Wash	boy
Kovey_	girl
Carl__Thomas__	man
LennyBoh08	man
Cometin340	dad
DJ_Slinger	boy
franklanguage	mom
trainwithESP	man
Bombay_1500BLVD	brother
Donthelegend23	man
astro_nut84	man
thesnuffy	father
sndmanjo	man
gampcm	man
Mohad_alhassan	man
BradmanTV	man
ShelbyBell403	man
Gex20XX	man
mSweeTmomma	mom
Kayleex3Brooke	papa
BryanWilkerson	man
NoahTuten	dad
alysonsisson_12	boy
marcosfacundo4	male
AColeRealty	mother
jp4464	man
Kingboss214	boy
thebergershop	man
__IV__	father
BUFFALOBEEZNEEZ	man
Spand_Ice	man
Salute2Dat5ive	man
edwinmejia_jr	man
michelezim	aunt
pinkmoet_86	mom
transitmatters	trans
ndionhairston	man
BethLeas	trans
carolinelawley	girl
sustainabales	man
tmj_aus_hr	man
MiamiCondoLaw	father
TarkanManer	man
SurfMommie	mom
julian5742	trans
BillyRamirez01	trans
ArgosBikeTech	man
CraftsmanBarATX	man
adamrmcgrath	man
hellagayoakland	queer
HimeROAR	man
ThisDrJones	father
ash_tab	mother
snnat17	mom
pmugarura	father
lionstone_kelly	man
kaymakenna16	father
RockstylinSiren	man
kkaipirinha77	man
tmj_IDA_transp	trans
gustlfm	mother
danicarocamp	mom
agardenpath	father
connorsb	man
ahsan	man
rharbottle	man
JumpmanBostic	man
ryanpitts	man
Christinelydeng	man
mpalank101	man
KMC_Charlotte	man
tmj_VAL_transp	trans
sheezaredhead	trans
benjvan08	mom
TeraBisceglia	mama
bryaneure	man
driftingtospace	boy
SivanAyla	mom
tmj_ash_transp	trans
NuDen_Ottawa	male
travbetweeting	father
tmj_ut_hr	man
JessicaSaxman	man
alvinakinti	boy
HeavySeasVA	man
tmj_aus_manuf	man
MetaSmith	man
alannaarrington	mother
KiDtheRebel	man
P_Smallz	mom
rudyrush	dad
craigpilo	boy
cesarcaudillo	man
bookmdanno64	man
tripphudgins	man
OneVeronique	mom
SirPorkaLot	trans
beingsalvador	father
StellarGem	mom
DrewCrawford7	father
amydowdle	mom
tigerthedj	man
drakobotello	man
datboyChicas	girl
susanlynn7	sister
seanbauman	father
jeckenroth	man
Macreesetheboss	girl
tmj_ID_transp	trans
KennethMcGowen	man
SeraphinaMarino	man
Iam_Miami305	mom
_kendrajohnston	girl
zorubd	man
antoniorealty	father
Herwin951	boy
pfac51	man
KaviBeamMeUp	trans
pdon1978	trans
daiglels	dad
3Stripewbb	girl
DavidHazeltine	father
Djfrankiefrench	man
ChefChrisEllis	boy
jmppinc	father
TCox_1	man
rockandromeo	dad
gurulloyd	man
AZ_Swim_Apparel	man
TrainLikeALion	man
NakedBert	man
davidsigal	man
mrs_thope	mom
OfficialKarenL	man
MAJIC_C	man
librarianvampir	girl
erikadarnell	man
emily_quinley	girl
PeretteGodwin	mother
JohnPLoconsolo	father
MetsyC	trans
MullerBevChris	man
sarahaddi	man
kREYptonite	gramma
DeeMozeleski	girl
XXXJordanDBBC	boy
hoobabob	boy
leedrake	man
madison_hood	man
dereklevendusky	father
SharronMatthews	girl
kevsmith05	dad
bkroeckel	man
CinthiaZermeno	girl
tazmann1970	man
nevadorecords	man
amykate4123	trans
NickLyellLyell	man
bobbyknndy	man
sheenaviolin	man
Karmaray13	man
thebonnierotten	girl
OrlyPRinKC	man
MickEFlip	queer
PenarandaWorld	man
EmergencyHooker	trans
TerryLeap	father
tmj_tul_transp	trans
alicechunt	mother
Irietribal	sister
ApacheMarieR5	father
talfishawi	man
TrophyComic	girl
KimWHix	mom
GillHurst	mama
jimwagy	dad
RobinPetgrave	father
luxerubbish	man
saraellenposton	girl
Reneerach	man
jvmcardle	father
stian23	man
MeganHunter1979	mother
rayalmeda	man
_lesliemcdonald	boy
HausBarFarms	man
lourdesgamez3	mom
nickhammons	man
amanda_kooy	man
18NOONE	man
saskys	man
SarahWhibbs	man
FitOldDog	man
TheRetuned	father
reginissima	mom
GaiaSalonspa	man
long_leggedlife	girl
olgasdelavega	man
yellowsunnshit	mom
LiaFumon	man
chewpacabra	man
chef_asanchez	man
Ryder_989	girl
TidyBoMann	man
kamigarcia	girl
thirstyreveler	brother
tmj_iar_transp	trans
SweetColleenN	mom
ScottEdwin	father
Dee2theKay	man
Officially215	brother
tmj_abq_transp	trans
ROCKBLOCKBAM	boy
JennyLaughner	mom
chrislotts1	man
cruciformity	man
JoviNation23	man
shelleymoore24	man
LikeShackleton	man
Vixin81	mom
iamDMiller	man
TannerFawkes	boy
kalabrock	trans
dancecisneros	dad
YunGboy2Really	man
KyleDStudtmann	man
CheyannReagan	man
AnxelaMillan	man
MrTobyL	trans
stratejoy	mama
LilMsSophia	mom
LuartCastro	man
_urdrgz	man
JadedDawn	girl
JonesyPaper75	boy
DaeMichelle9	mom
CrishaLomax	trans
Bret1110	man
B_ConscioUS	man
CHAOS_NEWMONEY	man
LilyArde	mom
Krystal_Lutz	girl
PastorMDillard	father
ChicGeekGirl	man
kirkholmes	boy
kirtfloydtrini	trans
Spazzymandy	mom
SopeLinda	man
noahbudnick	man
DamoneRoberts	boy
nayirikrikorian	girl
CamilleJanei	man
hyperdisturbed	mother
najee88	man
MauriceReeves	father
CalhounLynne	mother
Squeeblenaut	male
pinkemaria	andro
AlliParker726	mother
blackngeauxld	dad
JSBahorik	man
jchenelly	father
SafetymanDavis	father
OwenBell	girl
mleis	man
SarahDayOwen	trans
donniebaker	man
regnbar	mom
GigisTreasures	girl
TanyaA19	mom
romancesuave	man
KarmichaelD	man
tmj_CA_facmgmt	man
JuniperOnWater	man
SOULWINNA1	man
ShaneCarroll	man
RobMarciano	dad
drsmitty	father
drwigginsjr	dad
BriCrow_HTR	girl
JMLuchun	father
KWKennyWoods	man
jimmywicker1	man
amjconsulting	man
tuliodeleon	andro
jaw325	father
FoodAllergyGal	man
ImaniVina	man
bekahroy	man
slimt1213	mom
josieeeeallynnn	mom
krispykrunch55	man
HerbinSmith	mom
iKhoiBui	man
baptistepiriou	man
NicoleRomanoNYC	man
trucker_derek	man
SpaseInc	trans
jessicawmurray	girl
613JG	father
Matingas	papa
PastorBigRed	man
Mr_Whasup	boy
jonlseal	man
TonePham	man
lisalhirsh	mother
nancycruzin	man
presentlyrun	mom
0RazZ3	man
thedickboys	man
luxuryblurb	man
MrTinDC	dad
howardrose	man
greggCM	boy
perchofuck	mom
LArryLAvell	mom
Clanahan81	man
Bbarbhomesales	man
TheGeneralGrant	father
Lecto10	man
foxsmjr	brother
TimAyres	father
SocialPMChick	trans
oscar_gabriel7	man
emilyboyd12	man
charmy_stl	mom
gregschmid07	dad
DrGJCanillas	man
JoeBerm	uncle
steelstatue	dad
1andonlykatelyn	girl
Nemesis6470	grandpa
kb20008	aunt
bmmorganr	sister
HBK_SeanMichael	dad
dan_leca	man
bscottnewman	father
leao_roa	man
KingsBoxing_	man
kaleighboo17	sister
fnurmohamed71	mom
BrutusMaximus15	boy
cpaustin2000	man
kravsue	mother
elTRNDSTTR	dad
Prizzle01	man
theandrewkase	man
TheRealMercici	girl
SHAUNJOHNISHS	girl
jaminbrazil	dad
tonyframpton	boy
RicoFerrante	male
pogdeniii	father
OmarVeron	dad
TheOnly_MAFO	man
YaBoiDiggs	boy
SamTimothy	brother
SmellsLikeAmber	mom
The_Alpha_Bitch	mom
DaVoice305	man
HASAN_SS_GOD	man
hollibeauty_	girl
DebraGeorge	girl
T___Rey	boy
LilNaKKaSwaggy	dad
RobertHabeeb	man
LisaTorreFitnes	mother
calliefhall	girl
SabethaMumm	mother
thenumber3	dad
malikmlwilliams	man
nursekaren4	mom
bigzglokz	mother
andrew_py	dad
jmcentire	boy
jukeboxphotos	brother
HannahBrugman	man
loserboi951	father
SimplyTroy	dad
ProfessorTurner	girl
jessjudkins	mama
180studentguy	father
JoinTeamMTC	trans
TennisCambridge	boy
molbeats	man
itssamibitch	man
iamyonna_1122	man
leslietomaino	mother
caseydandy	man
RoyalTireJobs	trans
nicole_m_baker	sister
JIDickens	dad
MizzzRebel	girl
kaceyanisa	mama
Ash_M_Buck	mom
profalessandro	andro
deethinks	gramma
kavipaste	man
GSWESTOK	girl
joulescontreras	man
PearlWineCo	girl
tmj_IDH_transp	trans
JenReneePhotos	mom
PolarLava	man
sehuff1	father
tmj_tol_transp	trans
sunilthethrill	man
luciendar666	mom
CptSuburbia	man
drewberinger	man
ellen_wildman	girl
DonekSnowboards	man
kaitmeoww	mom
JhansenC	man
alexbarz	man
AmyWardrobe	mom
ArdianDoroci	dad
CarmeliaRay	mom
jhbenedict	man
ChefBlunston	man
MexicoSalsa	man
DjEzEddieD893	boy
ryan_bicker	dad
eejay	father
_GorgeousLucy	mom
BeccaStP	girl
DiamondKesawn	boy
PhotoBangBang	man
BlaketheMega	man
ninademag	brother
WestCstStruttin	boy
JeremyWenger	father
vsingleton23	man
illin_dillon	man
TexasToyzz	man
CourtneyEnders	sister
_LetsGoToFRANCE	man
trehug	mom
WTFtv	man
KathleenHenson	mom
HerAirness04	girl
McMemmers	mom
TommyCornelis	queer
DjEddieZ	man
danwentzel	trans
RFalcon74	mom
lounoyouknow	dad
mikegroesser	man
KimCulbertson	mom
secretsFYsister	sister
ffpratt	dad
geekkate	girl
AHeauxAssNigga	father
FlyingApple72	mom
emilygirsch	man
joe_klinker	man
authortreynolds	man
SamanthaSowden	mom
KimberlyMyers1	trans
tutetasustada	man
BossLadyBellah	trans
shanesmartt	trans
RochNyGregg	man
Ur_Lfe_My_Ent	man
hindamitchell	mom
Jamieowww	aunt
phatcatsent	man
tsazzara	mom
Security_Ninja	father
Nikki71	girl
tmj_NJ_facmgmt	man
NolaLynnePhotog	mom
hutton647	trans
ChrisFordisHere	mom
josephrshenk	man
covergeist	grandma
joshwaugh1	father
DanySilber	mom
GregNormanCGA	man
BCooperRowe	gramma
DeeDeeNewell	mom
JameyErickson	man
CorkbuzzCLT	man
o2bmeek	man
DrewKelly94KX	dad
tmj_IL_facmgmt	man
JeremyDScott	father
StephsGoodLife	mother
OneMoreCupcake	girl
KathiaHega	dad
samandkatedsign	man
Earth2Ashley	man
BrainofBryn	man
tapswithtor	trans
_heelz	man
WhatSAPPining	boy
shannonigans322	man
johnwhitney75	boy
AmandaFayeEST	man
alejborra	man
tomwest85	man
aamarotico	girl
caravanofglam	man
cocomo68	mom
brightonrick	girl
vamp_jynx	girl
VeRuBelieber96	girl
EmPlizak	girl
cawhiteee	mama
93KAYJE_	dad
CriosWhite	boy
ctcourt	father
AMPertplus	brother
batess	boy
KGronsky	mom
JMPhotographyMD	mom
themikegeorge	father
aleinfante5	man
Noriega_01	boy
Louie_Kapoohy	boy
tamara_atx	man
datjetsonfranco	man
nancyz819	girl
CWM1955	male
ChristiFitness	mom
KristinLynn1971	mom
WeeDiddy	man
wmougayar	man
ReadRbn	man
tmj_pa_hr	man
MariaRedfearn	mother
ManoAHernandez	father
ToriDoheny	man
noradenee	mother
wyxie	mom
Mlerch12	man
taraxhardy	girl
matt_which	dad
elainie1205	girl
Front_Paije	girl
nonessantiago	mother
MsHotwheelz	girl
tonycaldwell	brother
assuntacatalano	man
jmingram911	father
PrestonInside	man
SirenMika	man
RetroArtistry	man
goWATA_VA	trans
CiRuiz	boy
TheLegalTrap	man
daniellepeyton	man
StaceyJill729	man
Rembis50	man
terilyn_marshal	mom
BeingZeeJames	mom
clairesglim	man
LippyLiptak	man
lxchicagoxl	man
Morenitapetite2	dad
tmj_WI_facmgmt	man
TriciaThings	mother
JoelJAY	man
KhiryAdonis	boy
TeamDanteeeee	dad
qmuser	boy
PatrikSkywalker	man
tmj_lan_manuf	man
CokeboydjL2	boy
joywavemusic	man
ARICCIII	man
swirlgirldenver	girl
ToolShedBeer	man
MotherRoseBand	mother
fashionablymale	male
Travix1516	father
tmj_san_manuf	man
ICGAFIYLMON	man
Susankfeldman	mother
pienkoopman	mom
hannahjegart	man
KRocc_	boy
celticspiral	father
OhLo_pc	man
SummitRacing	man
saraHBrinny	girl
tono_ch	man
ScarlettHalo	man
dbthompson	father
tpearson1965	mother
hinnebusch	dad
BrookeMollring	man
HatfieldBryson	mom
muh_rye_uh	mom
trumpetdude02	man
theamazingaris	brother
SCOTTAWITTE	man
EOTBeerholder	father
laguzmandeLA	man
natanncan	girl
SingForMore	man
Chefchristofer	father
DevonTylerPerry	trans
MRDEEDSBAILBOND	man
BLSchoenberg	mom
MarkOglesby	boy
FarvelisR	man
WhoIsOSmith	boy
phineasflapdood	grandpa
topenga	man
thespia	man
mrtonylewisjr	boy
nylonsaddle	girl
CBBarthlow	father
JSymone	girl
TheMaams	mom
Goorley	man
SO_JENNY_	man
sstoller	mom
ElrodKyle	man
BizzleBoutique	girl
AaronLo77	man
amymiles1966	father
GirlsInTech_WIT	girl
MidTNMonarchs	man
brovero835	man
Floyd_Zion	boy
JacobQberry	man
BichieDepp	man
mellinderr	man
twilightmelfina	man
NorCalBMC	boy
iHouse_RIT	man
Skirmy	man
tenapettis	mom
HelloJanetLynn	aunt
PCBS46	man
IknowTK	man
mzsmokestack	girl
LynnwoodKing	man
JarvisBrinson	man
adi7anand	trans
morganbeach	man
Isaacrptv	man
ThaGoodFather	father
DAthree	man
mompobz	mom
ra_ol_bass	man
NaslShayan	man
BDiggs7	dad
MaxHeidelberger	dad
JoshJudyTunes	dad
kylemace22	father
_mzkesha	mom
GMR_RR	man
TravelBabbo	father
Zach_Zucker	man
cjcam	dad
SpudtheCarGuy	man
LyndsisLuxuries	man
markdubec	man
WGSTGuy	gender
curlycakes	mother
CreoleBeaute	man
roswellglax	girl
MarkBaquiran	man
beachycream	girl
DJInfamousATL	boy
austinMsosa	mom
EChambers	girl
JoeSymon	man
kaitlin_hagan	man
helpeleven	man
DanOFlorez	dad
zOe_bellee	dad
keithbmx	man
sercarfe	man
StormDog626	dad
TheScottEpic	man
keitheknight1	dad
youngskales	man
mermaidlisa	girl
ArtsandClouds	trans
FuzzyProxy	queer
mitsecurity	trans
igobyterry	man
PeteGlowDC	man
TheRealMrGcanga	man
ebeid_elsayed	father
PMustari	mother
JessMelindaTay	man
trm_life	man
JoeyBeatMonster	mama
c0nstanzacastr0	man
BrettaBaggett	dad
_Melisaj__	mother
HilariScarl	man
Arrrrlz	girl
StevenB1985	man
jd_roussel	brother
MHoskins2179	man
Messina_Hof	man
dubassassins	man
DankanisBill	man
paperescapade	man
24inspiredlife	father
PrisonStare	man
FergusonLance	dad
lemead	mother
bettifly	mom
L_Daniel_Zamora	man
JamieMcHenry	father
theitinerantone	sister
masxxxii	mother
jpmacnab	man
shantimom44	mom
enFOURcerFA2k6	man
faircher	mom
Gospelbroker	father
Josh_Halliday	man
bradeeznutz	dad
mgonzo	man
StrawberrySiren	girl
ERayWalters2	man
anyachristine	mama
SDFitnessDiva	man
janettaontwitt	mother
anesharose	mama
BobbieJeanAndie	man
SWHTown30	man
fulltimeGiGS	man
tayberryjelly	girl
andreataccess	trans
turtlegirl102	man
ZWanderingFrogs	girl
nikkiblovely	girl
mustangmannylv	man
MNederhof	man
kalena11	man
sorryimalex	male
moshpit23	man
Girl__Melanie	girl
MissMilks	man
Razah_Rubiez	man
ThaFocus	man
kshylayah16	man
blakk_kyleonCBD	man
DJOboyy15	boy
WoodyWhite5	dad
Comptonz180	man
Lillian_Wray	man
trmelton2003	man
rachieexoxx	girl
BenBails	father
DJCreepysPants	trans
mikeaguirreharo	mom
tangowithlove	man
MannyMtl	man
fashionabli	man
ibyserendipity	trans
MeredithFirst	girl
Shannon_Tripp	girl
AmanGoomber	man
slwimberley	mom
BlessedPsycho	queer
stacii24	sister
JohnnyDiggz	man
jt1984	man
HeygirlJChanel	girl
_veebeezeey	brother
DarrenHairJones	trans
writingmatthew	father
mitchyoung126	father
thedailycapture	man
NicoAmatullo	mom
Elliottsm83	man
ambeezy10	sister
UnhurdConvo	mother
ManNamedKim	man
programmehq	man
samanthaamcarr	man
decoystars	mama
stanleylumax	man
SireLeoLamar	man
Rishme	man
morgannelson	man
Sinestica	dad
MarcGuzmanHomes	man
Dilallo_	man
Tatum1908	mother
jaimesmichael21	man
dizeimage	mother
AaronRagsdale	dad
olanart	man
davidkaseykelly	father
JAWDAANDJAWDA	sister
house_war	dad
danielkimbro	man
Tsepish	girl
PattSyd22	man
MikePearson6	man
Ra_The_Chef1125	man
FeliSarmiento	dad
VincieCheung	girl
DuncanPhillips	boy
aestiria	girl
AkrodMommyof4	mom
santoast	dad
getfitwithla	mom
SweetAsElle	man
DanieleJanine	man
chloediane	girl
VictoriousKaren	mom
MattBartlett3	father
Atlas2686	brother
RenovationATL	trans
nikolaswenzel	father
PrimandPropah	mama
ZederTeam	dad
RogerMessner	man
DjMLuv	man
OuterHeaven7389	girl
moonvirgo	sister
kylie_angell	mom
simpsopl	man
jasonfoliver	dad
justinwooartist	mother
SydneyReising	girl
edjmoncada	man
tmj_mem_manuf	man
djpreskool	man
thehoppinghome	mother
Rainmanmoe	man
mattbeams	queer
MeIAmDerek	man
foodculturist	man
jonathanrchang	male
braxtonstuart	man
MVLainey	mom
vawardwow	mother
rthompson33602	dad
GodivaATL	man
gabrielecapo	man
JayLafray	man
81GMB	man
_RellyRell_	boy
ChrisLaylin	father
DariusDuhGreat	dad
tmj_fay_transp	trans
papalindo_	father
AllyssaKaiser	girl
tmj_har_manuf	man
RealKingHustle	man
rodemory	father
jlsalerno9	mom
ShutterbugCrfts	mother
JohnGalMusic	father
renjambre	man
DjDueL	man
Girrzimm	man
denise_guertinn	man
gaona_peter	man
GauntletFilms	aunt
Lifestylechic2	mom
PerformanceLab_	man
HeatHugg88	mom
tmj_sfo_manuf	man
valeriecrowell	andro
dorothayysimpss	dad
JawannRemy	andro
HotBeverages	mom
6malinas	mom
td8079	trans
TimPayne_	father
sarahseesworld	mom
JustinJohnGarza	man
DebRussoNJ	mom
DJDevinSA	man
teptepxo	mom
MommaShelnutt	man
TravisHitchings	father
mwepcot82	father
tmj_LAJ_transp	trans
mafervlz	man
whoismarymar	mom
CollinsAtl	aunt
_LalaK_	man
BstaysBizzy	girl
stooks1971	father
Reederundisney	mom
mitchsreiss	man
DjFridaze	man
tmj_roa_manuf	man
MoscatoMom	mom
alanfrow	dad
therealmitz	brother
CookinCovati	gramma
RishonBlumberg	man
Edgemon72	man
utwenty	man
riceboysan	boy
RealJdm819	dad
cheechmypeach	queer
itsgodstory	mother
Paparazzi_Rules	father
Lac04Lori	mom
ployyanida	girl
gazellewc	man
too_turnt_trevs	man
miss_shine_10R	man
AriWasserman	man
OmegaChessKing	man
WinfordLamb	father
DGEGr8	man
AndyMartinezJr	uncle
bjones	man
mckenna_webster	girl
AppDevPM	man
tmj_mb_jobs	man
JonathanSWest	man
AndEyeRunIt	man
louisvordeaux	trans
FAST_VASS	man
cieleATHLETICS	man
Timsmith_usmc79	man
tmj_hsv_manuf	man
GabeyyBabyyy	mom
Mitchell_Eddy7	boy
filler	dad
corinnnee_	man
ronniejordan	man
Lindamissal	man
BeerPongMB	man
Imanol_Arce	dad
jamesphi	man
tmj_nc_hr	man
toddkingston	man
GraceMcCroc	girl
tmj_phx_manuf	man
NatHarward	man
WesC_KillinIt	man
sarahiswinning	mom
ferniibanez	dad
turboricua	man
2DYE4_	boy
Oaklandtnchmber	mother
ynatrimm	father
jasonAali	man
Lady_Gagnon	mom
Natimeetsworld	girl
stratis_photo	papa
MoJoCMO	mom
StevenRojas	man
PPEHLab	man
RussellZane	brother
paulelester	mom
MrBrindleton	man
rockyvertone1	father
RJaiks	girl
mommy2pmg	mom
TheBlonde_Spot	mom
KingKaysar	boy
justdevin	man
AniTheTechie	andro
LadyGreenMiami	man
AlysArden	girl
edwardnation10	father
Huicho_C	man
duncanshuman	man
MusiKeLQT	mom
FatherPaulL	man
mikemacnaughton	man
tatum_prestley	man
LDFleming	man
omnipotent32	man
rawksongs	mom
xrbxxn	man
kia_runs	girl
tmj_MN_transp	trans
maribljmz	man
DianneBurnett	mom
BRewald	mom
EricOConnor	dad
Muertini	man
MoWest_BSU	mom
Caffrican	boy
PoodlebNoodle	man
Gyaldemburger	father
olvera86	man
mdgillespie	man
gmt903	mom
kungfusalsa	dad
Indie184	mother
flc	father
JackGrier	man
Dreamboi_j	man
AZSteve7	trans
fiercemua2010	mama
snag1025	man
SevillasCigars	papa
WhereSanDiego	man
RandallHimself	man
partynakedsd	trans
Arts_Ally	man
liljofromcocomo	man
tnabid	man
Mango_Monroe	man
bkkisha	girl
JessMKnoll	girl
twodotsdash	mama
katiemac23	boy
bjj_jedi_ref	father
abeeach	girl
511nyBuffalo	trans
Paradise_Tx	mom
damontaseff	father
ryanmunyan	man
rightup_urALLIE	girl
colorsflashing6	man
hahnjd	father
ehinchman	man
nela1322	trans
dschorrnyc	dad
DJFILLUPBANKS	man
arjuntrvd	man
lorienc	mom
Drkthunder317	brother
carolynbrown674	girl
ShayRyanJones	dad
modernoutlaw	father
So4RHIal	man
gregorycross	dad
juandeleon	father
lastingmoments	mom
lilsikko	man
MayaMachelle	dad
BradWickersheim	dad
1RafaMusic	man
Sessions_SF	man
BEATKINGKONG	man
KayteeTomus	man
AudrasSternberg	mother
kaitbarnes	girl
colewilliams98	father
DIRECTLYME	man
jdamasco32	man
TeamTommyNola	man
jesswilliamsnyc	mother
TheSocialLights	man
LatriceRoyale	man
BeccaTx02	mom
SRGRetailJobs	man
kylevthomas	father
sonyaannp	mom
Wenell	father
jobrazil3	man
kitschy_cat	boy
laurieallee	mom
AprilBeam1	man
ericabrooks	mom
GJoico	girl
gary_woodfine	trans
angel6571	mother
missydarr70	mother
JTSwierczek	boy
SenMartyGolden	man
JoeMillie3x	man
DjAsIs	man
mimlop	mom
ohkiv	man
djjc911	mother
LaurynMpeacock	man
KibweJohnson	dad
taibeau	aunt
DCOFFEE317	dad
DrJimmyBagley	man
MichelleXMode	girl
OriginalJoeDirt	man
Sakrodj	man
freelemoi	mother
JohnDeberryJr	man
chefmajor72	father
KylieGulliver	man
careyfarmer	mom
tmj_clt_transp	trans
TVanstory	boy
stuartdrogers	father
LMac54	girl
basquebombshell	trans
Shayach	man
therealyungla	brother
KeanoJoJo	girl
alainaskeys	queer
aroths	father
RockWit_Choo	mother
TheRicanAngel	father
nessdavid43	man
williamharris07	man
joerobinett	dad
King_Saladean	mom
o0oCircleso0o	man
mrjonasm	man
mikebettscook	dad
annasappetite	girl
scullness	dad
LilyJackCo	man
AlexMilanGolf	girl
DStarshockeyfan	father
Grosssman	man
robhenri	man
georgepayne11	man
BrandonRushh	boy
KingRuben23	boy
cuanimetzin	dad
tmj_VAW_transp	trans
healthyirishman	man
Moe_smack	boy
FreshBikeServce	trans
KilkennyTom	man
Prestigedmv	man
GustavMahler	dad
NicolasLemus	mother
roguepuppet	trans
leann_pollard	mother
kellyvannevel	girl
Hustle_123	man
Vanderlaandzoo	mother
tjelliott54	dad
Matthew_Hinman	man
Amanda8889	man
JimEJr	father
AdnanKhancious	brother
maryjanemmm	girl
Roobihart	man
IndianNomad	man
hayden_foster	boy
zomgitsamber	man
BiteSizeBlonde	mom
BeautifulWorld	girl
MsSarahHunter	girl
tmj_mon_hr	man
freifamily	mom
robinharriford	mother
CharleyCrockett	man
re_dwell	man
IsaieK	brother
tmerrill	mom
SIENNADREAMXXX	boy
Stretchlexx	man
o0exiter0o	man
ComeliaShawnae	girl
MattMarcus3K	man
johnpneedham	father
scottrheath	man
TCSoundMixer	father
Avylemarko	male
PeaOfSweetness	mom
caitlinalfano_	man
AshevilleEvents	mom
tmj_MOP_HR	man
jtuttle2997	dad
iamthekingdavis	man
SteveWalton22	dad
nicolasullmann	trans
tmj_mo_hr	man
BrianGresser	boy
befisher26	mom
HughMSullivan	father
taaalib	man
Kayluh1915	man
DrAustein	man
HistoryBoyle	dad
PreciousLeeXOXO	man
withthismachine	dad
KatherineByrdie	man
tmj_TN_transp	trans
sarita516	mom
BrianCRuss	man
LolaLola_B	girl
violetcriMEs	man
k2kristy	mother
RickCedWhat	boy
RDiaz_IT	girl
thackermo	girl
VICRAEINC	man
Cassie_IsWife	boy
OCDC1980s	boy
Running0nFaith	mom
ddelgado121	father
Giggisboutique	mother
FreshAsIwannaB3	mom
dtyler321	dad
tmj_iar_manuf	man
hilaryg92	man
MissxDivine	girl
DEBBIEAVOUX	mom
JJuiceBox	man
AE_Ludwig	mom
LaheimLifeJazz	man
Sneaky_Fat_33	dad
AdamRHouston	boy
DawnMinAZ	mom
adantorres85	man
ryanbrauth	man
ewmonster	dad
restmanager_chi	man
jereldemonte	man
Berserker1	man
Dan_Kapuscinski	dad
Lennonalex	man
ShawFloorsJobs	man
CLEVENKOTBgirl	mother
KingWillonius	man
dgod1881	male
AnneElser	mother
stevenhaderer	man
NikkiLA22	man
Zumaa	mom
crsloan	mother
leetaylor16	mother
RaisingZeplyn	dad
ALLYLOVESRICKY	mom
RunCiegeRun	boy
disneydancer16	mom
Funkdog91	man
DJ_P_ROCK	boy
raynashine	man
DyshaunBright	boy
HairyGary	father
tmj_NEN_transp	trans
JonathanMase	man
wolfmarine_393	man
Sandy_Sloan	mother
Jena9286	mom
hoch_chris	man
omces11	man
GreenMile08	man
joevanhartman	grandpa
GreedyMussolini	mom
cruicej	man
tweetibyrd	mom
determinedkid	man
oscarfrazier	man
Slackermomma	mom
anglibyerian	father
jc	man
VJLORDJAZZ	man
tmj_usa_hr	man
JaimeGonzalez24	dad
erinjjamis	man
benpike	man
michi83	boy
Commotion7	mom
poshlifesocial	man
LaGimenaGomez	man
Doobybrain	man
BigO305	father
kimaybe	man
stephenstephan	man
MCJOHA_CLR	dad
amcaylor94	aunt
pomsonfire	mother
hopesimmons22	boy
blstone7115	man
teamdbfitness	father
KaneChurko	papa
LizzylikeDrizzy	girl
ask_genna	trans
House_of_Swank	man
TheDannyMika	boy
alibrug	mom
UnzipaDawna	boy
Tecmo34	man
JFerguson50	boy
UlisesRascon	dad
LisenHelander	man
Katt_Pearce	man
zedlaV559	man
VadeeneS	mother
rubenromano	man
BiggAjaxx1200	father
cdflett	father
LKPH	girl
LaurenMix965	mom
PICTUREBOYY	boy
mipesoidealtlc	dad
KingsleyKwok	father
AHarlemMommy	mom
AlisterKonrath	man
GaryBlouin	man
RollerzOnlyLA	man
kchearis	dad
amyjheyman	mother
bbaltimorebrown	dad
D4TPinkHero	man
JackieC1989	man
rodocopmx	man
wyattwichman	man
GTGarrity	father
goTylerHayes	father
StuartWShulman	dad
EastOrangeFBBC	man
nrod67	mother
JustinJedlica	male
melsmithmakeup	mom
tattoosbydexter	man
dannylewis78	father
RedArmyHooligan	man
42ChristyLeah	girl
tomfox23	father
OGIIIOG	man
tmj_mt_hr	man
rserras	man
1KingTrizzy	man
leftbankgeneva	man
frenchylive	man
StylinScotty	man
alaetsch12	man
TeddyMakwa	father
nikkigphd	mother
woohoo_TRINKY21	boy
Fortheloveto	mom
Thomas68704	father
kateudurie	mom
KxngBlake	man
aubreezy81	mom
MarioOrozcoTV	father
MsMaggyMae	man
kevinoshea	man
liquidkisses	man
alan_maciasc	man
ogkeek	girl
Hakuzi_Hanzo	man
KalahLauren	girl
MilesJones	man
IceCreamLady104	mom
MzzChoclate	mama
Ezekiel_e	father
Cassiecass_01	dad
ReddPush	man
TerryLipshetz	father
tmj_nwk_transp	trans
RGGates	father
Hiper__Activo	dad
KilianChris	dad
chefmariani	mother
dinidreaming	man
caitlinramrakha	girl
RUNWAYBEAUTYRO	man
MAN_UPP01	man
doublegrr	mama
JamesHammer7	dad
run2birth	mom
ThisisAnnaG	mother
jprezidente	man
MancinoVermouth	man
daytonafitmom	mom
lakeraider77	male
TRVphoto	man
missjessimarie	man
killa_kiel	boy
melloykevin	man
angelwing06	girl
johnrodriguez	dad
MouserCareers	man
radicalriffs	father
gilesbrandon	man
quattrohello	girl
BigTimeAllStar	mom
BarreEvolution	trans
QCHelicopters	man
tmj_stl_manuf	man
BlessingSuzanne	mom
Judith4AU	man
vanessa_hanson	girl
AFateSoTwisted	mom
jordansheapage	mom
superbob67	father
groceryboi	father
AtxQuintero	father
_eatpraywod	sister
pedroultreras	man
LifeTeen_SJN	man
whereesKB	girl
AdriannaPugh	mother
JayandSteve	man
tmj_MN_facmgmt	man
jeaton84	father
russellboone	brother
meaghanbmurphy	mom
SirDJones	boy
CooksquotesW	mom
ineedsomemoore	man
rickamorris	man
MaNeMooP	man
kealind_trent	man
SunkissedDenver	mom
tmj_FLD_transp	trans
janrezab	man
whitenicious	papa
ricardo_jgm	man
go2_4realestate	girl
Darryl_Glenn	brother
DanielleMKane1	mother
sillysierraaa	girl
MorrisMNWeather	man
JeffQuibell	man
tmj_cob_itmgmt	man
Pchefy	girl
Henjealy	man
tmj_gta_manuf	man
alexadoyon	man
msn0828	mom
rayfri_49	man
damuzi9e	man
jackson_chad	man
JAyRodBMX	man
april_michelle2	mother
PlanoCityMgr	man
BernsCj	father
OliviaLeighJ	girl
pstachowicz	girl
bxprguy305	mom
ThatBoiSilly	brother
kimmvalerio	male
LiamThomasFitz	mom
DJBeeOnline	father
klassykimmy	girl
cheryltan88	girl
nyangosling	man
jmanuelm3x23	man
JamalSmithMMA	father
YunggDayDay241	dad
thewiwitos	father
pastorrperez	dad
heat_mel	boy
DLW1978	man
jr_prospal	man
DrDorisGriffin	mother
SerafinoSays	trans
regisaurus920	girl
Silverddragn	man
tmj_MO_facmgmt	man
tmj_MA_facmgmt	man
kfleisch	mother
LazyTechTony	man
jenjentrixie	mom
TheRealNfinity	man
Styl3z_P	mom
doubleLp	man
EronHodges	dad
aldasoft	man
Xavier_James	man
krm45	man
rumorsboutique	girl
SoMuchToSay919	brother
DRRNetwork	man
spotternetwork	man
tmj_kan_transp	trans
brandonmcneice	man
ericKnahm	dad
The_nRJ	man
danielisdrums	father
theislandgirltt	girl
PMSLumos	man
courtgwiz	mom
idigher	man
LittleJasFlower	girl
sdorf4040	father
AlexMGreger	man
mymakeupworld10	man
AmberC0413	mom
oatprincess	boy
Mr_DoneDidIt	man
csoly	father
Matthew_Connors	father
princesa__jade	man
tamcdonald	man
brad30097	father
DonnyMurphy16	dad
juliaxtorres	man
_taywizzzzzz	boy
taterrose	mom
risingstar52	girl
chairthrower	dad
nicoleborsey	mom
nolanolegal	mom
dqisaqt	mom
JasonKauf1	mom
arvanoostrum	man
tmj_sat_hr	man
KingElizabeth82	man
JuliaBerndt	girl
dyh9950	papa
michellelby	trans
Jesse_Horne	man
fontosaurus	boy
SensePublicity	dad
martinmo1970	boy
JAIDEEYOGA	trans
KeithRParsons	father
brucewilsonco	man
nomadnp	father
jacobrday	man
mizeyesis	girl
JessePrestonX	boy
MacyeHacye	mom
HoustonRabbi	father
Shelly_Peiken	mother
kevinjknight	man
gigdem	man
BeerGeekNSouth	dad
jnamadan	boy
PersianShine	man
BacardiMachismo	dad
LeslieFishlock	girl
HeatherRAllen	girl
ThtGuyMatKaczor	man
KevinOfMI	dad
JWGrindrod	father
coachq7	boy
MASSiveManJG	man
TonyRSanders	mom
ryan_chap_man	man
Savage3232	man
manhattan_mezzo	man
SaschaDF	man
ICC_Meredith	mom
JJamison48	man
leandramacd	mom
killaaa_CAM	mama
jenio523	man
tmj_msp_manuf	man
jets414	man
calligramme_pgh	man
maggiesmithpoet	mama
VinnyG74	man
JadeLallyT69	man
_MrCelebrityBoy	boy
bodyfit67	man
ninigator1	aunt
4everComplic8ed	mom
queerfatfemme	girl
timpaulbass	dad
CassyGarretttt	mom
jwahl_08	man
s_vandewal	man
magoo65	boy
JoyOfJessalin	man
ChrissyJacobs	girl
DConti710	mother
QAngee	mom
lolitesque	mom
iambigdino	father
mepinto	trans
PHWOMPA	dad
poshthash	mother
Mentii	boy
TheJohnHammer	trans
Mike_Gallegos	brother
senseijonscott	father
ASummerset3	man
TeamFoxRunnerJR	father
theJFord	boy
MattKeo	man
_BlahZae_	dad
mgmmikemiller	dad
rovingourmet	uncle
tmj_ND_transp	trans
suhRAYyuh	girl
tyrone_betters	man
WayneHarrison9	man
TheHollyDoll	man
chops_3300	mama
mntiger73	man
5andadime	dad
madelinereow	man
reyncloud	man
TheCandyShow	boy
AmorLovesJesusC	man
_nathangeles	man
FogelmanFMG	man
Leighgnzls	man
Elie_reyesrz	dad
KatelinMoomau	girl
MsSamanthaMarie	man
jgovereasy	man
RalphLHaley	father
zrodimel	father
asthegirlturns	mom
VeganYogaGuy	man
mtt71769	boy
iHateBooski	boy
NicoleZwiercan	mom
tmj_orf_manuf	man
JFraz_05	man
LindsayNK9	girl
KirstBallard	man
theerikbs	boy
Tafalcon24	man
DavidLozzi	dad
Sole_Champ	father
WendiPopRock	mom
BostonJump	man
ryesilverman	man
ashleypuida	boy
PastorChristian	father
BSmales	man
DPT_Rx	man
DEN_news	man
djscmusic	boy
klbaptista	man
kdwright416	mom
dancinbear0130	man
FrankCalhoune	man
ambeenie	sister
cookevillewxguy	dad
makenagranger	man
ToddShissler	girl
_ariail	mom
MANNYRODNYC	man
PhotoLesa	man
blytheaar	man
PhotosbyNanci	mom
kikekobenhavn	man
tmj_sdf_manuf	man
MixMasterRod	mom
jarrodrollins	man
Caszell	man
JansShenanigans	sister
KyleKittleson	father
mika_rice	man
kuppycakeninja	mom
ComedianJaySias	dad
JuliaNolan_	brother
JonathonGio	father
SeanBorgLA	man
DJKAYOTIK	boy
SoCalBeer	man
nekomeem	girl
cabo1130	boy
511nyBinghamton	trans
SabaHailemariam	sister
TheSunnyD__	mom
rossruns	dad
Shirazlikewine	father
lhshutterbug	mom
tiny_1983	father
Charlieflauter9	man
Baylor_Sigmas	man
stevemccahan	father
ValpoVelvet	man
jrmcdonald81	father
AVSMetro	man
CosmosVigilante	girl
Eric_D_Coburn	dad
MacMoGreen	man
sagepado	man
CHACHAAOM	boy
LT_ErinG	sister
MMaxOne	father
aaronmarkcole	man
Machete44	man
Emily_Ellyn	mother
aivettep716	sister
MarloDaMartian	man
AshWagner2010	girl
divasindefense	girl
DesignerDOD	mom
CopperCreekSpa	man
iam_Mr_Strong	man
emma31600	man
JennWadeRocks	girl
JayiKemp	man
VANESSA71737	man
jr_matthews	man
Darlyne_LaBrada	girl
LaurenNicole005	man
BlaacDzyre	brother
ScottLowSongs	man
TammyTayPowers	mom
autocosm	man
AnaCMariscal	man
fairbanks_miles	male
Staceyme06	boy
tommy_willco	dad
Lucis_King	boy
rmjacksonmusic	mom
Xavi7734	mom
meatjockey	man
jdurhm	man
JesusSepulveda3	man
JRoccDaddy	dad
Morales	father
mallorybaches	mom
harmanazad17	man
tiffani	man
rebeccacahua	dad
ErikaFromVA1971	mother
r_u_LDS_2	man
DezRay18	man
DrGaellon	man
OldEnglishD14	father
valb00	father
stephaniejillh	mom
reneenayy59	man
joelmchale	mom
GWCarol	girl
Malishame	man
jrsportperform	man
iamJamesPhelps	man
trainercoe	man
cmonterock	man
walterkiefer	man
3AmigosMedia	man
BennyFogle	boy
sbh	man
A1_Mike	brother
ianclang1	man
centsiblelife	mom
Aadi_Krishna	man
mattcase	dad
jocechewbacca	man
WindyCityAleBK	brother
The1andonlyJer	mama
samjimenez_	girl
thebenjami	man
thebarryproject	father
ItGirlMX	girl
jeniferc98	mama
teemichelle	mother
Grineelly	dad
maddieV22	girl
s_richardson22	girl
AllBoutCoco	girl
doce2000	mother
AMANDAbolic	girl
nekochan1984	girl
brandy2nd2none	mom
CatiMcGee	man
TriCountyJefe	father
anaiszanotti	boy
DianaSaldierna	man
MaxineX_PornXXX	girl
LynnCowell	girl
geoflevine	father
BrennaLeeRoth	mother
SamDouglas65	father
mskristinawong	man
beyoncittoo	man
DeyCallMeChiChi	girl
PrincipalReiser	mom
samdemaris	brother
CandiceCFitness	man
Realnolyeindian	mom
workingmomhome	mom
missbrown24	mom
GibbSquared	man
alphacafenista	trans
markhealey	father
teeharter	mother
AllWMJobs	man
missymissymissy	mom
marissaalomet	mom
robertoaguilera	man
PiercerTiffany	man
BeautyFaithFit	mom
MissaCharissa	girl
tmj_NJ_HR	man
Rocky_Rinaldi	dad
bacon8tor	father
lorenskaggs	man
MistyNYC	mom
JelainePJ	man
BizStrategist	man
revkevnh	father
JSherard	dad
CrunchDaddy	man
MarkLemoir	father
mkedobbs	father
BigtimeAallyhia	girl
karaskoncepts	man
WyvettaGranger	mother
meupsidedown	man
tmj_sfo_transp	trans
CallTheHotline	girl
MiKeMcDnet	father
Laura_Preston	mom
edicius	mom
Kil0G	man
lesterbator	boy
dorsburn	boy
nedtnugent	father
licalfonsopgjdf	dad
dchorba	boy
theparkercharm	mom
airjoshb	man
FiveTwoBoo	girl
Jayar702	man
wcameronmartin	man
jackoapostrophe	man
Edilberto_pena	trans
xoxochristia	mom
haldenj	father
GlamCosmeticGrl	mom
BmoreBlizz	man
VickyShyTeam	mother
kennysmoov	dad
CandysManager	man
amberversola	mom
tmj_MI_transp	trans
smileymart	girl
KarlaHoffman	mom
jeffroberts	father
Caitlinnn1212	man
kurtisshank	father
zenupe84	brother
JeffAbel	father
morgan_jody	trans
itsnotlucky	girl
NaturallyAlexM	father
denny2996	dad
thatlilsuperman	man
shawnmcombs	father
lizwentbigtime	girl
Manifeastophoto	man
jeneindia	mother
LucasNHall	man
Alemanywarriors	man
Blay_Vision	man
TimeLordBen	man
lovepeacedance	man
roewi	man
jonathanleewebb	father
El_GiDi	father
DaggaBoyTV	man
1worldomination	man
Pball001	man
giosueserran	dad
AmyHarber	boy
joeystromberg	man
Tim_Chadd	father
tmj_pa_manuf	man
mlhopgood	girl
phlashstudios	man
Jordan__Ballard	boy
tMillsSciTeach	mom
Mal__Martin	man
Hal_Gavzie	man
rach_eva	father
PDShinkman	man
totemlydrunkctr	boy
TheDJMission	man
CrissyDastrup	mom
WallStreetWalks	man
PatrickMuston	man
AmorLove1984	mom
tmj_chh_manuf	man
Wright4Wilm	man
pennstate90	mom
RomaOeh	trans
erich13	papa
MaddyMinter	girl
mikelynJoy	boy
AmmyTuwa	mom
xitijpatel	andro
jadedjcBXNYC	man
acruzpacheco	man
JamEnslaver	man
aynsavoy	man
willischinn	man
Btfrench	mother
emilynachazel	man
chelebelle8312	girl
511nySyracuse	trans
dennisreedII	man
Apostle_Vercher	mom
ariafwright	girl
hairmisstress91	mom
msninar	man
p_t_real	man
tmj_IN_facmgmt	man
DreamLiveBall	brother
joshuanovy	dad
tchilders	father
GraceTuetken	girl
AnthonyRubio01	man
waynewilcox	trans
FredShootToHelp	man
natemup	gramma
samnawrockiii	man
djpremonition	man
JRSportsfan83	boy
PQClark	mama
crystal_wheeler	mom
tmj_cle_manuf	man
ChristineLombar	mother
gwgallonegro	man
FlamingoMantra	man
linzzz3	girl
LSanz92	girl
IowaBirdman	man
diegueno	father
MaxAlanClark56	man
fangirlcantina	girl
kkschiller	man
evaporsshow	man
petejankowski	father
FaniK1975	boy
CoGeous831	father
suzydfauria	mom
tmj_was_manuf	man
teobrien3	dad
DaveHaydysch	man
jesfogg	mother
ItsBrookeRyan	girl
ReynoldsJackson	man
TheOnlyGonzalo	brother
RyanEstis	man
AmyEvangeline	mom
ForceBarbell	man
RolandoMolina71	dad
cmac1002	dad
BrianWright732	father
jps94	dad
mchz82	girl
WigglesTheHoly	father
jaclyntorrento	mom
Loren_Danae1	man
laruerob2	father
tmj_CA_hr	man
ShePeppers	trans
nicolelauram	man
Willandthewonts	brother
nancykatherinem	girl
Brigamusic	man
CarolineMorkel	girl
CuttyKev9190	father
MikeTRose	dad
Christy_Erb	mother
tmj_atl_manuf	man
jypagan	man
3xsuperbowlchmp	father
LauraWard23	boy
wintse84	brother
RobTyler24	dad
Pens66871	father
ABShik	dad
mz_rocko	girl
OldCove	man
pjmudd	father
BAnderson1939	trans
DaMeZapatos	man
imnuts07	andro
kreateafitlife	mother
lutzmamaof4	mom
TransitFeeds	trans
saynine	queer
tmj_PA_facmgmt	man
robinjeanharris	man
_Andy_Ryan_	father
team83elite	dad
pastorjasmith	father
KWillustrates	mom
anovachefski	dad
ssgjbroyles	dad
swaggaticchio	man
jennyshearawn	mom
kyno903	man
NikoleAngela	boy
cristinaafdz	girl
Summergal2	sister
wuhBAM	father
ChristineMcDe16	mother
_spacequeen505	man
LinzerB	girl
Justin1Grose	boy
aloabebe	man
Jlutz36	man
jjsgrl	man
rplucius	dad
andybrit	man
PurpAndGold1	boy
PineRoseWedding	man
KingMellMBC	boy
Beedahsiga	father
16RobCooper	father
Lets_Paint_Inc	man
bendearth	father
Tonyschuirer	dad
TheKyleMurray	man
nugloskin	man
VinceTripp	dad
DennisSalesGolf	man
jcrawford720	girl
malcolmgage	man
rosscranford	man
brettullman	father
nuBestsalon	man
ElRandomHero	boy
FrankieCoke	grandma
Shannonkelly926	girl
lexx_tweetz	girl
TheBossManRocks	dad
mamamareeuh	mama
martinpam	mom
Tiffany_Lopez	man
GiGiFlaGal	gramma
WILDTORUS	man
Blake91511	mom
mikedeadzone	man
karcik_kom	man
arekdreyer	man
GuillermoM_28	mom
kpwmediagroup	trans
toraayrogalskay	girl
lilteenbean	girl
Oliviaiafrate	man
kmdhenderson83	aunt
laci_loo	girl
LMoney201_	man
futuremrsrball	trans
THEAndyManning	man
seahorsesound	man
sixthsensevis	boy
marcus_teoh99	dad
JuanD_3P	man
drivius	man
DebisTweeting	mom
upmflorida	man
randomblitzr	man
alddoe	mom
nclshooter	dad
CoralTulumHotel	mom
ashleyQUIZ	girl
espiaramos	man
chantyberthelot	mom
Johosophat	andro
goofygirl66	boy
datstheshiet	man
jlynch3	man
WillMatthewsVA	father
scumbagology	man
LuvCheez	man
Bobby_Brown__	man
SiaSynn	man
Quan_	boy
DeLanceCrockett	man
anttMKV	boy
trufinancial	man
awsomehog1	man
KatMart502	girl
D_Genius	man
AmieMichael1	mother
FPROB	man
EternalGr8ness	man
howertonwooten	mom
TripleM7	man
NancyMags6	mom
JohnnieH7	man
heatherfritzpho	man
zachward	dad
WRIGHT_MIND	man
msanania	gramma
Hello___Kelly	boy
LucyinNorCal	mom
JeffEggs	man
TorrezLuther	father
Jilliannvieiraa	man
tommylomag	man
amarkpritchard	father
sarrraright	mama
MrsMeganTheRed	mama
JE_Uncorked	man
F1Breezy	man
sharpmeyer	mom
danontap	man
JPMZ95	dad
ealewiss	male
KittsteinerRosa	trans
Byronesque_app	andro
TheEricGraham	father
1MDOTTAYLOR	man
tbaudin	mom
Fiorella_im	mom
HarperKincaid	man
williamfuller74	mom
RudyOnBike	father
KShade27	uncle
CharisseMilano	girl
BYU2NFL	man
heyitsLatinaFey	sister
EatDrinkBrandy	man
mpinkelton	mom
Cigar_Charlie	dad
ChristyRiffel	mother
iamesseljay	man
rreihart	man
robertoghiaroni	father
MVPGO	boy
zakford	dad
LeDarlingChelc	mom
cshumay	man
ChelseaEllis11	man
BrentonGieser	man
DonCrenshaw	man
GnomishMath	father
rolewiii	man
MoMiriam	girl
phelobmeree	girl
Manuel_Quiroz_	dad
msKD2u	man
dgpr	man
dave__sims	man
m0mentring	mom
debgermain	mom
LKNSummer	man
TheHealingMommy	mom
ErinBurnette	man
jenfelke	mom
hedgewizard	father
DeezyDaPaperboy	boy
marxman34	queer
dbeale12	father
ChrisSInTtown	dad
rosaliaTWeiner	papa
ChelseyCurently	man
SonnySonnymoses	father
mariniertje	man
Cpdunk5	papa
cpagsgetnaked	girl
javirebull	man
sewnow	mom
bigmal35	boy
stacyreno	mama
EricIvar	man
Mel_missa21	man
tmj_mn_hr	man
tallbonez	man
MeganLizotte	mom
Jared_Blitz	man
vuhnessav	boy
pastordeelowg	father
scomoreau	boy
djerocny	boy
maggiemaetaylor	man
DramAntics	aunt
Taborifica	dad
johnparcell	man
DallasPartnerIT	man
aubreyzaruba	girl
Flacoboy	father
IVONNEKIWI	man
_julesgroshon	man
ENJohnson1979	andro
jeremylakeysr	dad
iLoveAnnaCakes	mother
CJJohnsons	father
MollySchuyler	mom
resichfamily	mother
StephAlpeniaB	mother
tmj_MIT_transp	trans
VishnuNS_	man
WalkedUSA	man
Stot36	dad
edouardvince	papa
CoolLikeHanSolo	man
gaypolkpayton	mom
mhenslee	father
bigbrotherjake	father
tmj_phl_transp	trans
tmj_njn_manuf	man
MTD97	man
StonemanMB	man
sandiaral	mom
WIDEAWAKEZACH	father
Rebadams7	mom
cshelby06	mom
ChezHopa	father
ratedmwines	man
Godspecial1	man
mzanyk	mother
lalopbar	dad
Pohlman	father
iamlyanlove	mom
MARIUS_DTOWN	man
osinfield	man
SteeleConstance	man
AHallNN	mom
ManofAF	man
revbwoosley	dad
FireSpazz	girl
JOTheRapper	man
brianvbradford	dad
TysanEads	man
rosita8907	dad
FreelyMi	girl
Socarides	man
24NicoleFrances	man
tmj_cin_manuf	man
RobertTalbert	dad
EricPuenteee	boy
ChrisWeidmanUFC	man
classikriss	mom
SuzannedNYC	mom
BaddieBoyBey	boy
OneTwoTrishhh	girl
djshaneo	mom
gi_24brother	brother
NieveMalandra	mom
tmj_usa_itmgmt	man
beercanmuseum	aunt
nathanwhite	father
niaandindia	mom
kevinwunderwood	dad
N_R_Newton	man
AngieAnge	man
will_po	man
tmj_wil_manuf	man
TrekMichaels	boy
DexterSCT256	man
JahbariM	man
BigDougW	man
JoeStobaugh	father
JaneticsInk	mother
Maumonotematico	man
SkyWalkerjonez	uncle
ezMoneyguapo	boy
marianik1968	girl
GriffinNW	man
Bloodz82	father
SueDuffield	girl
Zirus01	boy
jmcin9	dad
TocaBang	man
KissStephanie	girl
Johniio	man
DanGeisz	father
anjufordinner	brother
AssocForum	man
stacekz4l	mom
newdayalicia	mom
livehappy8	mom
danrako	man
jeffbtmnews	boy
smontepeque	dad
OfficialTwiggy	man
111sister	sister
davidzmorris	trans
ChristellePatt	man
Blues_Cat	man
jermainenyc	man
tonydahlin	father
PatriceLStewart	man
Laura_Woodside	boy
AgdaCoroner	man
CodeMiguel	father
Fizzieizzy	man
SPMJM	man
tmj_GAS_transp	trans
LaurenRaePhotog	mama
JohnUppole	man
DJ_MUSIC_MAN	man
BrooksLuby	mother
zig_e	father
Chewnano	mother
LyricalKris	man
iamdankaufman	man
Gisminguito	girl
flakmonkay	man
zcyates	boy
AllisonSemmes	girl
EsNetzsooc	man
ThatLife_Furst	man
queensoflax	girl
electroblake	man
RichPThree	man
Purpess	boy
centralbtlwine	sister
kclightrail	trans
sarah21210	girl
latinbeauty1987	mom
EmilyRose_woo	brother
SilvioRichetto	man
tmj_tul_manuf	man
skoryd	father
JohnLucenas	father
IGL_Jonathan	father
Jidda106	boy
_indy500_	girl
matthewklein316	man
scooley10	man
JennySoxgirl14	mom
TheALLMarTy	man
DONFRESHYBI	boy
TMET25	boy
kcovington	mother
el_onassis	dad
AliciaCBS8	mother
VictoriaHousetx	man
sa_gourley	mom
tgerbasi	girl
rosiesuz	girl
ianfitchuk	man
hansonemmak	man
Joshcrans	dad
TheAndersonPaul	father
ArtfulDodgeCafe	man
angelyne_marzo	man
MisterC2u2	man
ShawnWeigh	man
TamaraJackson24	mom
SraTLG	mom
drjwall	mom
tmj_IL_HR	man
Misahippy	mom
crasian_girl	man
msalexmenz	girl
GovHRUSA	man
sheroncrane	mom
Dat_dude_Cannon	boy
SA_Princess84	mom
AngelaDewar	girl
FitnessDiesel	man
HaitianChanpage	mom
tmj_al_hr	man
foodieyu	man
sthrnfairytale	mama
ninacreque	man
MarcMegna	man
tedeytan	man
Ekane2	mother
iiLoveYana	man
ThisMomWinesLV	mom
my4sons1994	mother
lindseyjmurphy	boy
GregoryPaul00	dad
GentQuest	man
jacquelinepie	girl
ScarlettHop	mom
ChrisNBrooks	man
sljudomom	mom
whoissizzle	girl
kendalsykes	aunt
gabstek	man
LevelUp_Evolve	man
elem1978	boy
ErikaLopezMaldo	girl
jswmediagroup	man
dperduegwd	boy
danesuarez	brother
taketheview	man
davidtribble	father
aabiud	mother
txelectionlaw	father
antonhyo	dad
Treenie_b	man
KellenOGrady	man
WillGainesokc	father
wdputnamiii	dad
josefisantacruz	dad
Rwakakamba	man
sambabody	man
chadclan	man
TiffMetcalf	girl
TeresaMcLamb	mother
vietvet52	mama
beergutbrew	papa
TarynLeigh75	mother
philly76er	boy
lawrencebagwell	father
FinlandsFinest7	man
csbateman	man
paamyurcid	girl
wilredd	man
GibranGBO513	father
She_Is_LadyWa	mom
davidnour	dad
tmj_VA_transp	trans
TapSnap1143	papa
larrysjoseph	father
Kyeshaohg	man
Larrison_10	boy
Whitefish007	girl
JessDanens	man
mariahoverhere	mom
greenflashnate	man
youthspeaks	man
DEricsonPR	man
niftynattylite	mom
larserarts	man
JayJonesHimself	man
MadsOrNah	boy
tmj_ks_hr	man
TheMindofDaniel	man
mnash183	mom
whitrn	mom
IndigoDeLunaz	mother
_Massage_Soul_	boy
moneymetalcakes	dad
tmj_NHC_transp	trans
215MoneyDialing	dad
insuremissouri	mom
pcabalen	mother
MindscapeEnt	man
samuelschoi	father
mastamike	man
shontellep	mom
Dan_Lenzini	man
KafieCigars	man
iam_Casandra	mom
ncdawn	mom
MorganFreeman7	man
DanielEquisMtz	man
playinlivinlife	girl
SkipWaughCH3	man
finaldraft	father
baylerrr_	man
CWhoa	man
grafetteeINKZ	mother
akari_cos	girl
iAm_Music2012	boy
nina_michelle	mom
MikeSalay	father
R_sergiio	man
run10K31	father
JRSprott	man
JoeAlv	man
joshizara	man
Dann_GLamm	man
Kyle_Prince0	mom
MrMitchellBL	boy
MaudsofBH	man
bionicredneck23	boy
tmj_MOP_transp	trans
ByronJH	man
EvolutionQG	dad
KPSprague	girl
ShannonOconno	girl
em_laux	man
jcruz	father
rubenpl	man
wandavaught	boy
Chinglish116	mother
SusanMBarlow	mom
TheJoseAFlores	man
BABlessin	man
MrPhantastic4	man
Anna_Affias	man
Sens_Fan74	man
testastretta	male
spdnyc	dad
Geo_with_SEABrz	trans
dmarie_3	father
dianadwain	mom
KateMoretti1	mom
yelllowballoons	man
jbrotherlove	man
TheAleEmporium	man
MrPoonSoaker	brother
OGJustPeachie	mom
renatalix	mom
wjlanier	father
Rbonista	mom
deonte_iii	man
HeavySeasMidWst	man
LexxiAlbrecht	sister
Operation40K	mom
Stephciliberto	mother
BrucePeck	dad
sole_iAn	man
RaeHummell	mom
oliviasolero	man
CognacXL	male
jay6375	man
HoodHowardStern	boy
PandoraStarlet	queer
AFRealty	man
chipmoxley	dad
MDoudt	father
kross700	mom
NickolasMayra	dad
JonverseAllStar	trans
MsPoloMartian	mother
Alankm360	father
DarrellHumphrey	dad
JSlayHerVIP	man
StaceyRumpf	mom
kevindavisphoto	father
Jahypimentel	mom
Wendymads	man
MissJadeTM	dad
BradKempMusic	boy
naizaaracelipry	mom
CJsPianos	man
jamidix	mom
JosephLamar111	boy
_abbimitchell	man
impalass96	andro
Bkey313	man
JRkrispy	mom
andyhalko	father
CandiCelebPR	man
Seymoursheriff	father
GITRIGHTSPF	man
PegCityJake	father
CameronDefy	man
wbrent01	father
BSTGK11	boy
hugosuave	man
HauteObjet	man
iembot_bou	father
EckertKeith	father
Uncle__Jimbo	uncle
livinit801	father
gbozik23	man
mrdannysanchez	mom
kathleenbateman	mom
CarolDLish	girl
jonrods	father
thomaskramer	man
adamauden	man
DesirayTaylor	man
coachshutt	father
SavortheMoment1	mama
robzie_	man
JulieNGelb	girl
PuyMan	dad
SUITUP151	man
TeamWee	man
OCMomBlog	mom
Basl87	man
dadiva18	girl
josephkohout	father
yeslouisville	mom
VCRangels	man
MDoTMancini	man
miamisofia	girl
4biddenPlastic	man
SikesBeerSE	man
DWinstead333	boy
FollowinChrist	man
MiaHopkinsxoxo	man
DLovveMusic	man
JFlarouche	mom
cassidykoviak	man
LisaODwyerphoto	mother
RebelHey	trans
POETLIGHTNING	man
benalang	man
REALMINDBLOCK	girl
ShamikJones	boy
Javiernquintero	girl
huttch427	mom
brcphoto	mama
Prettygirlmkup	girl
scbowman11	man
Toubee_Yang	brother
ashley_stika	man
miksim87	girl
jamesloughran4	boy
tmj_bna_hr	man
WestsideMommyLA	mom
misty_blu	man
victor_falcon	father
cordaro	brother
AprilFuller2	mom
blackmadonnachi	man
DJKDURDJ	boy
arose3	girl
NinitoDos	man
JoeFlowerz	man
LionArts	trans
MamaJRH	mom
CHERRYDAT5STAR	man
purreame	man
missdresix	mom
momojito	mom
CaptSamME	man
TheDenColumbia	man
chris_4ench	man
pioneercynthia	man
shanatweet	man
TeshawnEdmonds	man
Ichabod_	man
JenniferMackie8	aunt
bullionclayton	dad
Ashley_Corby	girl
northphilthyPEE	man
MonicaBravoYoga	mother
xojenn620	girl
tmj_TN_HR	man
Jerica_Phillips	girl
MarkWalczyk	man
tayhart21	man
Gal_Vet	mom
OfficialKFHox	sister
MP_Illustration	father
spartypw	father
nickbest1235	man
NSPGroupLLC	man
joshisagoodman	man
morettor	girl
cbsand	girl
michaeltuohy	man
MoonDawgHall	man
martelli_photo	dad
PauDeCoco	man
tunedinlady	mom
derreklemar	andro
ComixBookGurl	girl
FlappersComedy	andro
ChanLa	girl
StayGold_Deezus	mom
sherrymp	mama
Dixiech1ck	man
AlanKuehl	man
benrburge	man
FeliciaDavis312	girl
PBevBallNPrep	girl
WhiskeyClit	mom
MaybeNotPayton	man
thenerdygirlie	girl
navarro_jaime	boy
Ale_Mil	mom
tmj_tx_manuf	man
PoshNoshSlosh	girl
kc5fm	man
tkrikau	man
coutureplanner	mother
janierocek	mom
GonzalezSophia	man
cashmoNEERAJ	mom
ThatBoiPolo	man
GG_Advisors	man
chubonlait	girl
MusingMoonkin	girl
josiahcitrin	father
taddgrandstaff	father
TobyHelton	father
hassanpinto	man
Caleb_ATT	man
MsMonstah_	girl
daveahl	man
MartyDarracott	father
therealphasad	boy
tmj_ksk_HR	man
Marce922	man
ScottB_TD	dad
blaisethebaker	man
dianaelee	mom
CharlieM015	man
FraudFix	mother
BluSethSkincare	trans
sssimpson	mom
godwinanthology	mom
rafaeltmelendez	boy
tmj_pdx_transp	trans
HolmesPI	man
i_am_MANDZ	man
CHCofWyCo	man
SHERYLLyouBEEZY	man
JuanGraceful	father
kimorlandini	mom
MissMikeyM	man
keithkurson	boy
bachiles	mom
martinbrossman	man
DennisBray	father
tmj_okc_manuf	man
SouthernBridee	mother
ExclusiveKat	man
Juliannsmom	man
Davida_Belinte	girl
tmj_NM_HR	man
clockwork_photo	man
hawkeyelovely	dad
Just_Megs_	mom
paintd_princess	trans
tmj_dtw_transp	trans
whatpaigeesaid	boy
yumawench	mom
GOLDHOUSE	man
KrissyMConnolly	man
abbydorsett	girl
hannahjpy	sister
Nicole_GetIt	mom
RocioHdezBustos	dad
tmj_las_transp	trans
BeardedGator	dad
nny2k	dad
icandycosmetics	sister
djmsjackson	girl
Jack_O_C	man
CharlieHllywd	man
nikbaron	gramma
letsbeKHAlear	girl
YesImBarbie	mom
ChezFeroce	mom
papichulohowie	mom
_cornwallis	brother
jerushaaimee	man
ChrispFilms	dad
jagsharma	man
TunaToast	girl
buttah_face	girl
jessica_woolsey	girl
ArethaChapman2	mom
Reneeswaynyc	girl
WasingerBarbara	mother
DorseyCarson	man
educatedlady	girl
csi_dmc	man
godolcevita	mom
petetackett	dad
teamdlr_vegas	girl
LuceScrew	father
_DJReece	boy
AllyRyan09	mom
ewoolseywdrb	boy
aj_mass11	dad
jakelagrone	dad
CortBraswell	father
Jayguira	father
xxrdotxx	man
stevencmiller	trans
smellensheely	queer
alexbeech	trans
mitzitwoods	mother
lingersoaps	mom
LisaMartin1013	mother
alison_denner	man
iHateKaraMel	mama
thephatboi74	man
dad_or_alive	dad
DjCowboy	man
Ken_robbins	man
banazir	uncle
LittleJewelofNO	boy
sillsk	man
gsoutiea	man
sonikkic	girl
sasiitaboniita	boy
iamkalikat	girl
Kurisu______	man
LeanOnLindsay	girl
MrRojoERHS	man
TJZaremba	father
MotoGraphicUSA	trans
csuci_rec	man
SirJKM	father
always_tiff	mom
donnagriff	mother
SIRIASS_NYC	man
CHARLIEACROE	man
rick_sarmiento	dad
missa_nyg	mother
tmj_cao_hr	man
mike_delfinow	man
ACunit122285	man
tmj_OK_transp	trans
flyermile	man
JMoneyRed	man
nikkilovesbilly	mom
robhatcher	man
drewramsey1	man
sasaprasa	mom
RichardMize	man
ShelbyPilot	man
mrsoulmarkj	dad
jkingmurddoc	boy
Vixenj0601	man
ohpgirl	mother
risicomp	man
RampageSk8Shop	man
beblk	mama
MxicoExplora	dad
inhouseradio	dad
ScottieBMusic	father
tayfloww7	man
dancemissydance	man
AJLagar	boy
porro	dad
aavargas73	boy
poohbearhln	mother
DeR3a024	man
tmj_sac_manuf	man
hashtagDJBJ	man
CaptianYardsale	man
strixier	sister
ParkerDusseau	man
VintageToph	man
nedroberts	father
tmj_buf_transp	trans
TylerRAubrey	man
ajnoriega46	man
drumr95	dad
michael_levitre	man
0w3w	man
PaigeFrantz	man
nwunrow	man
LilMona13	girl
jfsandcompany	man
Dj_U_T	girl
endurejewelry	girl
RachelMStevenso	mama
Marguhhret	man
djunique23	boy
Paul_Rock_City	brother
DawnAlicia93	girl
hayleyhobson	mom
typodactyl	queer
lmohorn	boy
Tinika_Bell	man
Shelbyraymom	mom
ChazMabry	boy
ValerieElisa	man
susanpinokc	mama
LucyAngelo	boy
BoogF	father
hillarygayle	mom
Innoxxie	man
PowerTapeMethod	man
switchboardaust	man
tmj_in_hr	man
DESSERTISTsam	mom
ShandraIrwin	mom
KeonsChiq	mother
cmq_x3	papa
MadMasaya	man
lisa_snedeker	mother
tmj_orl_transp	trans
lisasilvera	girl
TunnellCareers	man
MissyRaetzel	mom
RhemiCosta	boy
ThatVegasGuy	mama
djsoapbubble	man
AKobeevg	man
Alfluent	man
manuel_arelio	man
cliffpavlovic	mom
speechpath08	man
annembray	girl
cameryn19	girl
dvallejo18	girl
LEOSKID1	boy
OSFalconHoops	boy
DrSapnaSriram	man
Korn4	man
milton_araujo	man
tmj_lan_hr	man
mkmorani	girl
StoltBerserkers	girl
katestwo	mom
zaca	man
josefonoltelefo	andro
lkmm5683	girl
greeneggsnndsam	boy
cjmmom0416	mom
FITNYCPamela	girl
tmj_mgm_transp	trans
NathanReed	man
LivingGalleryBk	man
pknapp	father
Mazasmusings	man
lidalouise	girl
catyla	mom
ForTheLoveofRee	dad
RachelGraciano	man
MatthewHornNH	trans
mamasmiles	mom
livelikeagypsy	man
movesmountains1	man
hartmanlrh	man
DRESthaBEATnik	man
MARIADESCHAMP	mama
sanks07	man
lildebvegas	mom
Kellog23	father
luism_merca	dad
bholman33	father
chefdanparker	father
DJMikeGarrasi	man
KinkShoppe	gender
emtpgump	dad
ag_tn3	man
michelito03	girl
Guissy	mom
DaymDrops	dad
TaWanna_French	mother
Marco_Promo	man
alexthet_rex	man
n0handlebars	mom
tmj_MB_skltrd	man
Professor296	man
LORIN21	man
MatthewCJarvis	man
quality_talent	man
transporter_ne	brother
amandathomas90	man
jumpinwaves	man
dunkco94	aunt
RexandRegina	man
PremierShowgirl	girl
acadianathrifty	mom
RhythmicImages	mom
BassManAbe	boy
Lidi_sSs	dad
AJH_RN	man
KD4U2011	man
jbazemore15	man
SarahDancer94	aunt
mayuubeauty	man
cpotts	dad
Skullitor	male
his2Bless	mom
admoore50	man
imonet73	mom
Parsakarimidost	man
KlaudiaKaye	man
Nick_Za4	dad
AhabNossPhoto	mom
barby_chabela	man
tmj_cae_transp	trans
ArsonDaOne	papa
AndreaC007	mom
DjSophiaLin	boy
ANK818	girl
01ANTHONY_STARK	boy
JoeCannon110SBG	boy
writegold	father
adrenalinecoach	man
benheustess	girl
CSXCareers	trans
CKMarie23	man
The_Black_Bond	mom
LadyBLove1001	mother
mrservice	man
chefchadwhite	father
Brigittezozula	man
Ortokaev	girl
TVStudioGrrrl	man
WesBrawner	father
AntoniettaESPN	man
nsarwark	father
gilserna89	dad
lindsay_pixie	man
StanRudman	man
trevormcneil	dad
Angelique829	mom
PincheOscarin	mother
guitarsrock87	girl
beamazingmom	mama
IHPfit	man
robot_nation	man
madhu091087	man
infinitism	mom
Papas_Kitchen_	papa
FollowContinuum	man
JpNeZz	father
GoodGirlPR	girl
sofijazz	girl
ChiILMama	mom
JessMontoya830	mom
psionicprophet	dad
MyRoomRocksSTL	girl
mbthegr81	father
MoMAPS1	mom
EchelonPrincess	girl
SashMachine	girl
tmj_mke_hr	man
Neighborhoodist	trans
Bugsbass	dad
IAmDavidGrants	father
cheryld126	girl
SherriGrin	man
LBChandley	man
_fashionate__	girl
rockngal	girl
FouZ	andro
beanandbeatrice	mom
WORKMAGAZINEfm	man
LColondeMejias	mother
Adrey	man
dcrimz	man
RoFromDC	man
nosleNakcirE	man
N0handzshawtie	girl
MsRobynCohen	mom
DakotaDancer	girl
JMANCILLA57	man
mamarazziof5	mom
CoryJKKeaulana	man
kingcoriv	father
irishays	girl
oretham33	father
SarahCampbellNZ	girl
MarlondPutman	man
KLRoyalEra	dad
slider12985	mother
IanAdAstra	man
MsIreallyloveme	girl
tmj_MA_HR	man
zhivonyoung	man
tmj_cle_transp	trans
WhitlowEvents	mother
Medivance	man
EricAnthony92	mom
tonheloves	dad
EQG_Jared	mom
pizzarium_us	man
Viki_Vampi	mom
brittdasheet	man
SteveKLord	man
RamblinHarvey	dad
Julia_Alexander	man
rbigaugotham	man
tmj_fl_hr	man
mrisner	mom
regionsjobs	man
tmj_sat_transp	trans
BrownFormanJobs	man
Goats_Udder	man
BLifeMansfield	man
dirkahlers	man
VodkaGirlATX	girl
manithdapplebum	man
CRParsonsComedy	father
DarlasWorld86	mom
jenalin	mom
jbbailey919	man
tmj_VA_facmgmt	man
DavieDro	man
AntoniaRobinson	mom
all_star_jp	man
SizzlingFajitas	dad
jasonginman	man
NoahMallin	dad
Bedlam_ShowOff	boy
YaBoiDLoy	man
L_A_CruzRamirez	dad
Skyler317	man
DeannaBanana25	man
jucao	dad
DansPartyGirl	girl
GordaChula826	grandma
TeamDiamondTX	man
MacKidSWHouston	girl
jeff_bloem	man
cameroncraig	man
rpmwaesh	girl
briancoats94	father
BurgerBrielle	man
carbert3	male
MrMySkinIsMySin	man
SadieColan	boy
spincitycoffee	brother
KatyyBaker	man
mel__appel	man
TArrowsmith	man
caregivermom	mother
Moongoddess1578	man
AnthonyMoseley	man
mrsbfastwnick	mother
roates718to561	man
_rene__	man
CHUCKY_TME	man
DBoy_Iacono	mom
aaftonn	girl
Antony511	man
GolamMollick	trans
memovallarta	man
GT_LightishRed	uncle
MilesBoucher	man
B_Maren	man
emoleechen	boy
michele0608	mother
IntheHandbasket	mom
lesliebdavidson	mom
laneylamz	girl
caseyroch	man
sewmuchcooler	mama
Myriam_Lo	dad
chadziggy	man
JerseyCityVegan	mom
MerbearMN	man
GambrillCom	man
PatBoBomb	man
koolkalikev	man
gcfio	dad
tmj_slc_hr	man
BGBeraBhenge	girl
amandajoy2013	girl
GK_JOHNSON	father
victorialeigh13	girl
lisayoungdesign	mom
le_destin85	man
RoddBuddha	boy
sandybryan	mom
JenniferOguzie	mother
Cheyday514	man
Shea_Dahuja	mother
TobyJMorris13	man
MVLeschper	mom
nooga	man
RADfurniture	man
daniellebc15	girl
tmj_clt_manuf	man
peaceluvtrance	man
seyoung101	man
ArthurLawler	father
AniTa_AdeT_	girl
Jperez201	man
AdamMix1051	father
MrRivera619	man
RAIDERBOY_818	boy
MeghanGentz	man
Rio_Cervantes	man
M_Dalesss	dad
AuroraMiami	girl
caseyayers	man
thatboyasad	boy
gugachacra	dad
NirmalCurry	man
Danywagen	man
madeinameiraca	mom
FPWellman	father
VMC_41	man
DJDieselPA	dad
jameylfields	father
TheRealTomH	man
sassyradish	mom
drumninja6	father
tmj_IA_facmgmt	man
dre0320	girl
emmaddern	mom
vijayharipal	father
yusufyuie	man
RegularJizzo_88	boy
tmj_bal_transp	trans
ellaesco	sister
nixon1019	mom
DJAngieC	mama
dfitprofitness	man
MagicManBand	man
Coach_MelJ	mother
robcooper22	father
tmj_SFO_prod	man
tmj_sjc_manuf	man
Boham	dad
danawittie	girl
CeeJay4_	dad
ThePaleViolet	girl
rjflesher	uncle
CgirlsR_uwg	girl
peaceLOVEnSue	mom
stbernardla	man
la_monstruita	man
LLCrewJay	man
Rey_Rapada	man
KimCaceresUSA	mom
Logan_Loveday	father
Gimme_Facey	mother
jesslynjo	mom
gilson_chase	boy
DJAmandaBlaze	man
bikerwalla	man
ijophes	man
BishopJRTaylor	father
jewelrywithme	mother
jniesz	dad
tmjmexmanuf	man
WomackandBowman	man
JennyKateWrites	girl
KathleenNGrimes	girl
iembot_sgx	father
CCUPerformance	man
shelbel73	mom
baszel90	man
wendihenry	mother
nwkhr	man
bowloftripe	dad
josefapickmans	man
HawaiiSong	man
m1cey	mom
vnssb	man
ahock7	father
ledbeverages	man
CecilDon	dad
juliamaestylesR	mother
KyleFerragamo	man
billgeurin	father
tmj_fre_manuf	man
LaModernaNYC	mom
Jess_NatM	girl
IAMFishbone	man
_JessicaDawson	man
memyself_n_my2	mom
quixoticash	man
theironkurtain	queer
davidggeorge	man
StanleyManuhutu	man
tmj_IAD_transp	trans
sucolnot	father
FraserMorse	father
revelation1922	mother
CharlyPi	male
akupedoc	papa
tmj_sfo_itmgmt	man
tmj_IA_HR	man
jim_burks	father
staceymcclellan	mother
CreeperCK	dad
TeresaAGuadagni	girl
FresnoREmarket	trans
tmj_mob_hr	man
JAD77	father
inkybink_N2	dad
Bschaef_	man
EenerReppoh	man
gdonaldson	man
JMFE13	boy
llm17	girl
wllfrn	man
ScottEastman	father
justgerreka	dad
Go_Cres	trans
EricCarlson7	man
slptwinmom	mom
christyboulware	mom
bsent88	boy
YahdoeMusic	mom
SeanJ8	man
acquisitionhbc	mom
MrsWrightWrites	mom
week_of_wonders	man
jimani	man
tmj_bhm_manuf	man
tmj_cob_transp	trans
HurricaneCyndi	mom
HeyKikeee	dad
AlexT_NYC	man
train_esi	man
Morgan_Newman	man
LuiFregoso	father
bukhrin	trans
iembot_pub	father
BILLPENDLEY	man
hazeleyegirl63	mom
PlanetManny	father
AlexGaleth	man
jolenenavarro	mother
LeslieHorkman	mother
fam_man	father
DFLAT87	man
foyboy1983	father
Sushi_B	man
Viruzbit	man
tmj_rip_transp	trans
Patrickmolina	man
pawsitivlycorky	girl
JohnnyDamon2	boy
ViceMayorWesB	father
NuttyNomads	sister
Samantha_Boz	mama
Feinsodville	man
kaitlinurka	girl
joshbecht	father
perfilin	trans
robertm73	man
leandro_fossi	andro
sydkroll	girl
DavidMTaylor	father
erickzc	boy
srsjesena	man
aminaismindless	girl
ScottyNack	boy
Princess_Clark5	mother
tmj_GA_transp	trans
sharishawstudio	man
lacreid	man
kileynovak	girl
ezazamora	girl
MichaelTalJ	man
thatgirljacks	girl
NicholasK_LA	boy
POCWASN	mother
ren_studio29	mom
TayAlisonSmith	girl
deannadesroches	mom
Wigglemom123	mom
boknowsfitness	man
britanytherese	man
8BitTony	man
Himmelheber10s	man
bacspin	man
friesen_jared	man
bscottracing	father
ChuckElledge	father
overXdoseO	girl
tbakersimmons	mom
BowTieDG	father
Kayleighxo6	dad
antaresbrown	man
KristinLitz	sister
k2agct77	father
damatanina	man
MiniSimp	brother
livingDL	mom
tmj_ind_manuf	man
MyaLover	andro
voltronprod2010	man
cjibo	father
Pajango	girl
StreetPoetsInc	trans
BeachKings	brother
JordanOliveir20	uncle
annettewon	man
taramanisbenson	mom
1AshleeRicci	boy
BethDarian	girl
bcfd9035	man
BensonCallahan	dad
cliattt	man
ronforbes	man
Missbluepro	man
BeverlyJRollins	mom
fabeverydayblog	mom
codyg1985	trans
LyokoTravels	male
EchoesMike84	man
SunniAndTheCity	girl
ProfeshNerd	man
GarMar88	man
dadaevan	father
kaytlynmarcotte	girl
NotCommonlyJoe	man
LaLaCoutureGirl	girl
T_MOOSE442	man
itsrenegarcia	father
TaylorCarson5	girl
CamNoNEWTON_1	man
alysontx	mother
mirellytaylor	mom
kevinmcdaniel09	father
tmj_AZ_transp	trans
earthtokarissah	boy
DJLENNYG	man
rossyvalencia	man
eyemusing	man
IBIGDanielI	man
KeeNic0le	girl
analilalunavlz	dad
TheCombineSC	man
roxburykor	man
UNANIMAIntl	mother
christinemfit	man
k975	andro
KarenPaddles	girl
AllieFeldman212	boy
GilliannW	man
HarleyTheSwede	man
muralarts	trans
kaseyroz	girl
erikaosberg	man
erinehight	man
emilioasis	man
ouryogahome	man
NikkiG6656	man
Mr_Antonio_M	man
suaderock	man
DoctorLezli	mother
JeremyLecoeur	brother
The_TrndSttr	dad
JustCallMeKourt	girl
SusanGunter68	mom
Mugglemom2	mom
JuanFritz	dad
kwieseman	man
matbriz	father
alissamcircle	mom
SubeckBukowski	man
milo_ny	man
_MJTheDJ	man
maaddiiissooonn	brother
DenBoomer1	father
bmmc5	father
joshuasheart	gramma
keyundreameadow	girl
48hippo	man
RockeraENT	man
eprahs	father
apetogentleman	man
RwayTwibbitts	man
vegasjoker	father
Whewell37	man
scottshaykett	man
ihanson7	father
RobertPrimesPT	male
TeeMo602	boy
nerfect	man
heatheranne_	mama
IsraeelBR	man
jg_erickson	mom
GagaFoodi	man
MCAlviz	man
CNotes1Hundred	man
LizAnnHawkins	mother
dfravel	boy
jaypapasan	papa
ivanvn89	dad
cupscene	man
lizzie_b	gramma
LarryColl	father
toogangsterforu	man
jogawithjana	mama
ProdGuy	man
GingerBearLMC	man
tmj_fre_transp	trans
sertl	man
smtaylor12	dad
ilanportugali	man
jtdant	dad
lscreeden	girl
CourtneyL_44	man
SRPartist	father
emchrostowska	girl
Riemerville	mother
BlkWolfSuarez	man
okctj	father
JessLynnCreatve	mom
mandbvintage	girl
SingingPhillip	dad
heatherjojoy	girl
ItsTimeEnt	man
MomentumHamONT	mom
therulah	man
simondudley	man
MikeLWriteWell	man
bgdolo	father
pastorbgreene	father
MangumMichael	man
Sam2D	man
nagrommit	father
markamimura	dad
Ecsta_Sie	girl
DamienAtBlakes	man
mariawoike	boy
jasoneatonmusic	dad
tmj_mia_manuf	man
gwoodsterrell	man
PearlJavs	man
JK13	father
JeniferGolden	girl
Jaime_Rivera	man
olgap222	man
GayleBailey	man
_jaelah	girl
Coffitivity	andro
kmac1433	man
nick_gw_	man
MackenzieMedich	girl
jnicollespeaks	mother
DmWright23	boy
Gl3nsNumb1	father
analuna02	mom
MannyWallace	man
carlpierre	man
misskitcat	man
ann_ueno	mom
SallyIbarra	man
EmuMariana	man
Babyprincessmom	mom
RachelBoguille	girl
chaos46692	man
GabrielleDerrig	girl
ClintRinHumble	dad
sianetta	girl
ms_kylesteward	mom
luvinme42	girl
tbpfitness	man
MeLiSDorn	man
AustinAncell	boy
G1Rhythm	brother
mamawolfeto2	mom
isaacompton	father
ArmyDrRunner	man
StreetFairekj88	boy
jeffzeltwanger	father
randomduck	trans
hhhhhhhillary	mom
SunShineTilDawn	girl
werkingrl	girl
CanisiusAMA	trans
iamtomaree	mom
tmj_cae_manuf	man
steph_palein	girl
vellvita	mom
ErinEloise	mom
WhoIsEddieKane	man
Navymex14	father
logical_jt	man
hellobiju	man
emilydickens	girl
iversonic	man
WessRocket	man
SashaHorne	girl
BMORE_REDZ	man
mutovkin	father
ChefLouieFayad	man
Saileene	girl
untamedxdesire	girl
TyBeezy11	man
thisisShizzle	man
chriii_charles	brother
NickFrangella	man
maeghansmulders	girl
JacilynMikels	mom
reyvarsko	man
tmj_CO_transp	trans
BUGENT239	dad
ladyfay1	girl
sumtxkid	trans
Pabmarti	man
AngelaPanama	man
OneSquid	man
Titanrichelieu	papa
TheGJQ	man
devonjimagery	mom
mfuiava	mom
djdmil	boy
violetd19	man
ASFreed	father
_seditio_	girl
burro388	boy
KARLAS001	girl
enjoikris	father
ENFHope	trans
lesleysillaman	mom
jeremyflint	father
JoeSoHeady	man
NakylieM	man
BIGSHOW67	man
foodnutlove	man
Tiana_Lynn_	girl
princessdesiree	dad
cindy_mespinosa	man
Kriiztoph	dad
NateFenimore	father
KristaMarie22	girl
CoachBoots2	man
manuaLsdrums	man
justin_hokie	man
michaelgoitein	man
trinidad_iii	dad
EllieNikit	girl
JustGim	dad
mckeemichael1	dad
ditchtheclutter	trans
CynzJamz	mom
nerdkusi	andro
tmj_hsv_transp	trans
ReporterBartonD	father
elenaroselight	man
SO_CHAMBER	man
AlejoMiranda	dad
mytotstravel	mom
trainlikeme	trans
chalfant	dad
ryansaline	man
DjAslan	man
keiraanne	mom
JustinBrokar	father
speedygo	man
Jason_Self44	dad
MarciScott12	mother
MHTalent	man
rs65	andro
loramarie03	girl
AretskysPatroon	man
realtyrocker	man
P3picquet	mother
linecook	father
ltedson	girl
LivAliveSoGroup	dad
sylviahubbard1	mom
MrVickJr	man
TrayjStar	mom
isdscuba	man
EliseGainer	man
JakeLewis043	man
tmj_brl_manuf	man
1stephencollins	trans
_876God	man
Fear2Tread	girl
SoFLBrgOverload	man
MIDDLEMANFRESH	man
mystahgerri	man
clvoorhies	man
kikecarriont	dad
GregMacway	man
TheJCNetworks	man
choytv	dad
collinsc9	mom
keilamarie	man
mzthundercat713	mother
mundanemagic	mom
joshrsmyth	dad
VampsKnockout	man
ItsPatRichards	man
2WheelJourney	brother
InChicagoSedan	trans
solidschultz	man
MisterMcCracken	queer
LyndaMSelf	mom
TheLovelyEloisa	dad
MusashiMixInq	man
ginamom	man
tinnodelgado	trans
TomBrandonUK	man
trippywxlf	girl
FF_EMT_Pous	man
broritestweets	man
meginaction	man
jyanis	father
metageeks	man
mayeli400	mom
goatboy91587	man
PTCRuder	father
cmyers2000	man
DocJamesWhite	father
DoggieDateTampa	mom
GreggWilson	man
MariePAnderson	man
PeachyTattoos	girl
jarretlover	mom
DankwaBrooks	brother
KelseyMerschman	man
slim1fan	boy
OlahiwaPham	mama
beccapires	man
misszuania	mom
tmj_MOJ_transp	trans
nicwags	mom
San_MiguelAngel	man
laurabenson4220	man
SheaWyatt	man
mattdejohn	man
PhyllisOlive	mother
jeremiasmedina	dad
BobLoyd	father
grloftroy	girl
LuxuryAttache	man
kerryanndunn	mom
gregawashington	dad
Violetworld	mom
roxzannlynn	girl
tmj_fl_manuf	man
jcm2173	father
senormundial	trans
MothersCantina	mother
santaperversa	man
aromo19	mother
tmj_NY_facmgmt	man
MikeyWhittiker	father
RubenUbiera	man
AjaxStacks	man
NatalieNirk	mother
mike_caesar	man
ilianaDLR	girl
RunWithK	girl
dardraper	mama
rebccacho	man
nclaxmom	mom
mikemost	dad
WordOfTorres	man
romanagiulia	girl
maruja1022	mom
AshBG	girl
Chungmula	man
hrserrano	man
Fladeboe	man
tmj_usa_prod	man
theluckiestone	father
eshriner	man
GothamChick	mom
Moxie_Manda	trans
James_K_Jones	dad
KyleBottcher	father
Daphify	trans
carlbjohnson1	male
nattybratty	mom
ShonHyneman	man
JamieOwens	dad
B2HopeAZ	trans
kellymiyahara	man
sam_see	man
FrankOliveri	father
Jtrainer21	boy
tsantheson	mom
DonMagicShawn	man
Rob_Huddleston	father
FranceLJackson	man
deannerussell	man
BDtheLeader	brother
JesseRas	dad
AlissaHudak	mom
JeriDickey	mom
Rocketland	man
franknostro	man
zzjitterzz	male
HueyBriss	man
Laura_Ronnie	man
annettechinn	man
toddwhitley	dad
kevinlemere	father
ichoosethesun	mom
CoCoLove220	mother
chrisconde	queer
michellelliman	man
PollmansS	man
dray4255	man
George_Ramirez_	man
DaMonsta1234	dad
LondonV	girl
PrimetimeGH	mom
ImEddieWilliams	brother
WHOISDJVOLP	boy
jpetrosini	man
240front	trans
KRDRAGON	man
_troz	father
LHSaltyDog	mom
NatalieCarreraP	girl
renee_sunshine	mom
BlackForestDeli	mother
EricaJenea	mother
thedancingspiri	man
MarkStallmann	man
wickedoll	girl
grantagerhart	man
transfersusa	trans
GoldenWestMgmt	man
tedhatcher	trans
PGilbert1986	man
nojyelof	man
erikastruth	girl
leslie1028	mother
efaprojectspace	man
CoachMike1991	dad
angelballance	mom
bradgraves	dad
dmarsek	dad
rae_wray	mom
Mikeo001	man
MemoryCreation	mom
golfsoup	dad
jk0ng	man
cboeupt21	father
djjaredcurry	man
meganreber	girl
nikichickie	mom
MyClosetVault	girl
JoshAppel	man
HankLHayes	father
LadyRoxyXo	girl
drichards21	father
al_asrar	girl
michaelperry	man
ajleephoto	father
hokiefn90	man
Almondy_Stuff	man
BoutrosBoutrosG	man
tmj_NAS_transp	trans
kelseyh_18	girl
jennesworld	man
KatieMaryBarry	man
LifetimeTrvls	father
ghostryder68	trans
JenMellon	mama
Victorsofyork	man
chuckgomezDP	father
JayJersey14	man
ExecutiveEditor	father
CajunSweetie_06	mom
brookeshirley10	man
RebeccaKelley4	mom
jessgoon	girl
vfxguys	dad
AllieMcNamara	man
archer_heather	mom
tmj_dfw_manuf	man
rubberchild	man
AmberKline1	mother
iprosinski	mom
tmj_gta_hr	man
NikauKai	man
pastorjmartin	father
kimberly_irwin	mother
curtisparkandy	father
StrataIPC	man
AmberSteward5	man
Rafaelluish	man
joekndy	man
IFBBkiraneuman	man
kishau	mom
Samismuchmore	man
Beccatonix	girl
susanlynncope	boy
Brett_Burchett	boy
NoelleToff	man
namtrok	dad
Luis_Saucedo_MX	dad
_King_Corb_	boy
TylerWTVO	man
CVermule	father
emlizhall	mom
tmj_phx_transp	trans
jackschull	dad
blakescorner	boy
Fajitaboy	father
briahnamartin	mother
howardcollens	man
CoachJIsaac	father
CatalystLTD	man
reipuerto	man
tmj_bna_transp	trans
LaurenMaillian	mom
dr4shlrDC	father
jmussuto	man
T00th	father
MandersonUA	man
tmj_ctm_manuf	man
TexanStrong	boy
chrisfrich	girl
flyguy2010	father
DevDarDes	man
DannyLybarger	father
SergioSolisTx	father
AHobbsRacing	father
jpmorgan26	father
samenriqueztat2	father
JDBickle1	boy
fabyGuaymaran	man
2TrippyMane2013	man
amcdons	aunt
CopleyPlaceMA	man
sarahsposh	mother
Omarh_n	dad
MeredithMiner	mom
DallasThomas3	boy
tmj_sjc_prod	man
mattradickal	dad
mmdubya	man
Beckyberry822	girl
amallitalli	girl
dmarzinke	father
A_Deuce	man
MaddMaxx5196	dad
beingmaclane	dad
morgan_tc	father
JasonHampton	father
josefresan	andro
pastorgregumc	father
AHosselet	man
wjbodin3	man
MzTiffiTNT	man
Dasexy1	mom
BloodSpite	man
KATcrisp12	man
bfordham	man
KalidonOfficial	man
AnnetteMarie84	mom
pfafftuning	man
LuisAlberto_VM	man
SergioTundo	queer
KeatanMarie4	man
dancinlawyer	man
TSDAGENCY	man
tonyimberi	girl
DC_Prepster	girl
kristiebolton	mom
samanthablev95	man
TimHowey	father
_JayTheCONNECT	man
nickquijano	man
YUHSB	boy
MagicNeverEnds	dad
tmj_NYS_transp	trans
eguryel	father
Selectajerry	father
angnicsmi121	man
Bunnyx100	girl
CTazz93	man
Gustavo_AvilaC	trans
ivanchoovando	mom
StrngthBodyMind	trans
OldDirtyBrandon	man
orlowskijp	dad
BostonGalaGirls	mom
gotstrength	father
andiLsmith	man
blkbridalbliss	male
AdamDown	man
karan301_	man
writerdrew	dad
bcloritts	dad
quietleather	man
MangoMediaFLA	man
ErzenDesign	man
beapattyy	mom
RomanticTwist	man
FableVision	trans
cici_yo	girl
SPDoubleYou	man
TheChubbyMDSays	man
fauxpasofaSM	mom
boomsygals	girl
actonallday	trans
Armentality	dad
Grace_TX	mama
jamal_j_wash	man
tmj_ILS_transp	trans
KimRocha	mom
sabrinaleana	mom
PCC38Lightning	andro
grammyvoter	man
tmj_scc_manuf	man
STLwinegirl	man
jewelsbymejulie	girl
jdubilicious	mom
tomison61	girl
gopro_kaea5	father
thedon_73	man
the_su	man
_RickyJohanes	man
OMAatMU	man
V_Shubayeva	man
DenverBeerGuy	man
hartjshirley	mom
baylee_holder	man
MsLaurieMcLean	man
JScullyClemmons	dad
iamjnorf	dad
kathytrithardt	man
RichTucker	man
jsekiddos	mom
ADRIVTheGoGetta	girl
sarahschwind_10	man
DJAce	dad
BIG_George_NYC	father
SantinaMuha	girl
joe_deckard	father
FitnSexyGuys	male
michael_me2	brother
adampowers22	father
kelsiwhirl	sister
Heey_MrCarter	man
_pako_mty	mother
umarmaggi	man
ruthie_sangster	mom
JoeHagelmann	man
ABlackGentleman	man
myweirdass	man
scottagoodwill	man
theswalkersmith	dad
tmj_bna_manuf	man
lahhzelll	boy
jhob2181	boy
chusma99	man
jbrealestatejax	man
Hvillearts	man
starpadilla	man
hesealwaysgrant	father
tmj_il_manuf	man
m4tt28	man
trbsocial	boy
tmj_phx_hr	man
Rob_Cook87	man
madddawg7	girl
EmHorsman712	man
TyleKurner	queer
sarabia_94	man
BigDaddyEsho	dad
annetrujillo7	mom
BigTopPhoto	papa
omgitsgrrrrcy	girl
rebylynn88	mama
JonLanderos	boy
lovelyleo0809	mother
mediaphish	father
fbaskopru	man
tipcan	man
phlyboipheynix	father
SkinWellnessAL	man
evolvefitnessp5	dad
brodElla311	girl
alyssao916	girl
SDirishFAN	father
tmj_cob_facmgmt	man
JMirandaMarquez	uncle
BB_Chic	girl
wesleywoods	dad
brianjohnriggs	dad
DrLepervanche	man
daresayer	man
aModernMaverick	man
steelmagnolia01	mom
lheaalisha	mom
xK80Monster	man
KimberlyRBuck	girl
HMSHostCareers	man
fmlinardo	dad
AdamJoelWorship	father
omargarrod	man
SHebug19	mom
Maxkorp	man
citojm	father
nicjonestweets	man
aleksarodgers	sister
DiannaDiToro	mom
AthleticsSFHS	brother
Daydalaus	man
girlfridayc	mom
vanessa_ilona	man
sinyalynn	man
makalahkrick	man
IAmRobRyan	dad
tmj_lan_transp	trans
Katrina5663	girl
kathsantana92	man
kimpita	mother
iKGeezie	boy
TheDivaDogMom	girl
AvaDarnell	girl
commonmel	mom
EmmanElmo20	man
Mic_Larrry	man
Laidback770	man
ladydi7182	girl
ErnestinaLondon	mom
OKFsMom	girl
SteveParten	dad
herbertholler	brother
Urbanfarmsista	mother
andelman	man
The_Nadex	man
DesignSteph	mom
OJPerformance	man
DustinHarper_	dad
amanijae	man
DonSellari	dad
Taborda57103	father
mjdempsey	andro
tconradx	girl
Linz_2111	man
3lindvision	father
JOESIMPSONBEATZ	man
AmandaFarina15	man
jjklee	man
nessagirrrrl	girl
RickWadholmJr	father
erickrasno	man
belugadetoca	girl
jkrahn	man
mshepley	trans
DJRoberts84	man
joeytraywick	father
bellewsc	man
acthompson23	man
Koons17112	boy
lizwriteon	man
quads_guy	dad
Jacky_Live	mom
reci221	girl
CashTribute	man
pwkavanaugh	man
Rober_SP	dad
paulatinamiau	man
loolindsayhoo	man
HF_Jobs	man
fidel_synn	boy
ethanjweiss	girl
CyndyCelmer	man
jddapper	man
JaffetAvila	mom
JudyNetworks	man
vaagen	mom
grandmasterneil	man
KCooperRayCHS	man
uxrui	dad
tmj_dc_hr	man
alisongene	man
tmj_MS_facmgmt	man
stewsday	man
HannahSun14	girl
willie_hendrix	boy
capecodlaxref	mom
KelmanSteve	man
TastedBeer	brother
chefkenna	mother
Felipe68	dad
GreatrAltitudes	man
Irv_se	dad
tmilavec	man
rachfoust	mother
letter10	dad
Rationaltruth	father
SamanthaNikk	man
negttor	dad
DocSavag	andro
crueheadsixx	girl
droby93	boy
CharleneJGray	mom
JohnFischesser	boy
TaraItalian	aunt
Noah_Lucas	man
DanforthCenter	man
jeremy_bell	dad
shannonrandall_	mom
BrianNorsman	father
KTWhiteL	girl
FollowFresco	boy
Sophiakazolides	man
DSharpEdge	father
WhiteRose65	mom
JonespersonVA	father
cores_one	dad
allanlouvre	man
Fit_Curvy_Chick	girl
jorge14segarra	boy
FR3D05	boy
Redshirt_FreshB	mama
tmj_SCM_transp	trans
SandyPembroke	man
Knox_Ins_Ben	man
TarahProPhoto	mother
kflash7	man
thetrainmon	trans
EmilySigler	grandma
austinpeed	boy
shawnTyler	man
karlitafutt	man
dustinantoine22	man
DavidDuRocher	man
miamundy	man
MickeyCarrizo	man
angelabrooks	mom
JLeeOilman	man
VelozDamaris	mom
Thenomadfashion	uncle
luannschindler	man
CPudel	man
kibbe	mama
IDStraining	dad
SwellDSM	mom
rmproute66	man
japangelito	man
TheMirnavator	mom
ivantreiner	man
VincentDynamo	man
JamieEhl	man
LaurenDPetersen	man
WilliamFilipsic	father
GabeMuller_	man
hoogieontheroad	father
stevederive	man
FuelFoodTruck	man
karyngreer	mom
jfeckart	father
MarkLudema	father
sara_jean	girl
jtuckOx	man
Dwain_Thomas	man
tmj_VAW_manuf	man
farbthebearjew	man
SoBrianRowe	man
senders	dad
tmj_INK_transp	trans
IamFischer	man
MorganKaileigh	mom
imatthws	man
MormonBoy	dad
ryanwalseth	man
KGlover98	man
acvcolor	father
TimeTunnelToys	mom
WiltonOak	father
seananderson76	father
itsDTrain	man
ahynes1	man
alprinngg	boy
TaoOfStrength85	man
hannahjoiner	mom
tmj_jax_transp	trans
QUEENNIQUE78	mom
bradaycock	dad
samlistens	man
Kahnle1	dad
CoiTajoDesigns	man
emgeFantasy	dad
tasjatastic	girl
THALLESROBERTOO	dad
Toalmaster	mom
MelindaPGentry	man
_BronT_	man
MsMichaelaPaige	man
Butter_and_Figs	man
nadiao1478	mother
eduardocofresi	man
RhiannaShell	mom
gmoney0330	father
ilona_selina	man
serendipity_414	mother
bretra88	man
kulbirghai	man
KoreyVanWyk	man
IAmMrFrazier	man
PanacheLancaste	man
BreMaxwell	girl
nat_smallish	man
lover3002	girl
AustinRDean	boy
_LoganGirl_	girl
coryenglebert	man
GirlsIncDC	girl
aaronarnwine	man
HalMarieRobbins	girl
MunderaMedia	man
tmj_bal_manuf	man
FarukHdez	man
ActorAJRivera	father
GBpackersfan_xo	man
hannahkthomp	man
MattKnicks1	man
samhyager	man
LucyJayKelly	mom
NezarAltubaishi	man
LilybugHugs	mom
TgCarola	dad
alshatti47	man
SaRaiya_X0	mom
sus13_mx	mom
tenncyn	mama
GetFitWithTanya	mom
EmmyBrem	man
MichaelMIA1975	man
foreverstein	girl
nostringstheatr	man
ShowPatrol	uncle
TroyAnderson6	man
iamwyred	sister
itsmetiffanyb	mom
PJConnolly	trans
The_Grindfather	man
GallandFer	girl
chrisfluitt	father
berzerkeley	mom
ClevelandJeff	boy
mellowmamita	mama
BabyBoss87	mom
tmj_COB_prod	man
KellyAArnold	sister
EPSCOT	father
lettyg22	girl
BalancedBoss	boy
joeberry3	man
amnichols	mom
frankiecorrado	mom
MamaLaurenR	girl
Beergut_Hayes	father
Riemaldo	man
BONESTHESWAGGOD	man
StrawlarryMilk	andro
Lando_Coffy	man
THADUDDAMAN	boy
511nyLongIsland	trans
debrouillard52	father
CarolineBurt	man
ZenOfJazz	man
tmj_mns_hr	man
RobVaka	father
clounsbury20	man
RachelFulkerson	mom
evanmjohnston	dad
FamilyTravelNYC	mom
CoachbrownLemm	mother
Nuffsaidmarko	man
appasmomo	girl
KingVeracious	man
Adam_Langer	man
IMDERRICKFAREAL	girl
thuyandme	dad
TUNOERESPOP	trans
ohSOprettyLEE	mom
MzJLynn82	mother
JAKELACOSTE	boy
NotJamesParsons	boy
downsDrew	father
KeikoZoll	mama
mattgraham79	dad
AZCat89	dad
PsalmOne19	father
argelys	man
rickdawg35	dad
iambillmccann	man
ccwriter	man
katejohn11	girl
KellyV_83	mother
xxDFISCHERxx	man
briannaesimon	mom
sevenfigz	man
lepetitpoutine	mother
RichMan425	mom
reesespcs	mom
erikagreenX	man
YogaByTerren	mom
psmaneewong	man
MrFrankBillini	mom
MedlockMandy	mom
DavidLeeGold	man
JOETURNER210	man
uxrick	man
MrJNiceWatch	boy
clemieux	mother
THEEPAULPUGH	man
ReImagineBrewin	man
NicolaParish	man
emilebeaudin	man
DeborahCorbet	man
urrrkaj	girl
ephamilton	mom
JBradPT	man
Sellshisvisions	man
BXMLefty23	dad
sjbmolden	boy
dom__bob	man
Orangesmoke14	boy
Get_Rice	man
PatrickMBrogan	father
MoneyGramJobs	trans
Lzava014	man
Toughturtleboy	man
_CMNEM	man
tmj_sfe_hr	man
randomfishboy	man
tmj_mem_transp	trans
MaureenEggleton	man
marirosa_lamas	mother
Rickonia	mother
tmj_sfo_hr	man
snapfile	man
tmj_TN_facmgmt	man
chanel__ali	girl
TrentBown	father
DaVinchiiWoods	man
11crisz	man
tmj_TX_facmgmt	man
One2Desire662	mother
LuvBeing_ToyaT	girl
jax_05	man
BritZur	man
JayYoo	father
ColumbiaMSSM	man
DJ_Romestallion	man
MannyWorld_	man
artwmn	trans
pinklemmon	mom
greenwooddavis	mama
AliLevineDesign	man
brandon_beard	dad
DaRealJustinG	girl
ZavieJ	man
StevenBridleTx	man
KpjCoffey	father
tmj_unh_hr	man
sj_ackerman	man
TehRubenDC	man
GaurdGirl	boy
Bikehappy	father
MikeHenries	dad
siobhana	man
ThomasJCoppola	man
dunkelherr666	man
BitsofLace	man
TL6_the_Gallery	man
vanillakillla	man
amandanbar	man
ohhcouture	man
MartyFranklin2	father
SaraiRangelS	man
TheBuckeyeGirl	girl
tmj_DC_facmgmt	man
erinexplores_	trans
Rach_D15	dad
saltnseaco	girl
Donnie_rydz	dad
Cowboysafford	man
travelroute3	father
josiesolomonn	man
akabaloo	brother
Vintage_Iron	man
martyboardman	father
HollySales	man
mplserik	trans
ThisIsMrBrown	man
Marjie_Girl	girl
snobinart	man
Loopz30	man
Kaitie_Wadey	man
miae_cho	man
DjL619	mom
LaurynElise317	girl
MerayMA6	man
tmj_rch_manuf	man
PrincipleEleven	man
coop_diddy357	man
Justin_fotog	girl
MrScottCassidy	man
anika_emily	man
isumom2	mom
andrearene	boy
ItsJaxonMusic	man
tmj_mem_hr	man
lisamissaggia	grandpa
montyinthebank	man
tmj_WI_transp	trans
filmmakerfor357	man
AisleBBach	father
GiantBreadbug	man
cJamesGoff	dad
jairo42	trans
PearleNorth	mother
bigddonblack	father
d0gsdecoded	man
alittlebundle	mom
mikeheyda	father
aardolic	trans
JimRJordan	man
tmj_va_hr	man
jmbeyond7	male
t0l0k	man
DJMicTee	boy
djskibblez	boy
ShannonD904	mother
tonnagirlsgolf	girl
tomtheatombomb	man
playboyburgt2	boy
RWHarrell3	dad
captbruce	boy
BryanneIsInRF	man
Mc_Slaya	man
silver_antelope	dad
TravFilmz	man
BarbWeckBrek	mom
ninakopetka	man
JoeDanGilliland	man
Carolyn_Wellman	man
WFLAPaulM	father
chefmichaelbb	man
RayvenLeGrand	father
3lilGApeaches	mama
beth_boone	girl
Jamie_Sterls	father
Dowbiggin	mother
dailyyak	dad
big_t122	man
lakergirljen	girl
tuba_man	queer
russmarshalek	dad
missyrae333	mama
carloscollado50	papa
AllanAumento	mama
katrinawoz	mother
josefrealty	mom
DruffLegend85	man
tbangerter	boy
NLWidder	man
KaneMayfield	man
tmj_ND_facmgmt	man
mondrup	man
marcioeli	dad
TicoSoto	father
carlosatmac	man
truesinger85	father
LB_Blazer	boy
Brian_Colon	father
CBLuxeConcierge	trans
DJSpacekid	man
StonedNToned	man
Hostensean	man
Shewantsdahogg	mom
melaninthrills	girl
pinkgloss18	girl
chriscostner	dad
MooreIMSScience	mother
kimowens64	mom
kellyeclaire	man
_ellelu	girl
johnson_thad	girl
AlexRobFit	man
CandicePeak	mom
ArnelCalvario	man
karesann	mom
Royalty_5thAve	man
kyleJRgray	dad
jeffmagoo	father
tmj_NM_transp	trans
coffeed_scorpio	girl
JoachimTheodore	boy
Jason1Goff	brother
amrammel	father
Lori1080	boy
urbnomad	man
KenCarpenter	man
EmilyCratty	girl
JJ4EDU	father
amber_oxley	girl
neumaverick	girl
GregDeHoot	man
rome_oo7	boy
_talkingbird_	man
EverCastro92	man
TheRealLadyTee	boy
RalphPaglia	father
likeacircusgirl	mom
with_RM	brother
kaytaybicks	man
WesDunn	father
kevinbcharles	father
MedicalWtLoss	trans
caroline523	mom
GNitro	man
DShadoan	man
jessikrolina	dad
jfield1869	dad
CHUCKALAS	man
orafferty	dad
KentKoons	man
Rayblinkie1906	father
JazminHampton	girl
synjenherren	man
tmj_MD_HR	man
chrissythornton	mother
UnionSoundHall	man
MRodgers2405	boy
LakeRealtyNC	man
fleurdecurl	girl
JBANKSFL	father
tmj_njc_hr	man
Tsaiberia	mother
RealBBN	mom
SlickLikeFerris	man
only1kraziek	mom
only2degrees	mom
louderthanwords	father
tmj_chi_manuf	man
tediously_brief	mom
CLworldtraveler	man
emmaseason	girl
B_Fjord	man
haidarrahamut	man
JerseyMutt	father
bbla_tay	man
KaylaKeyz	girl
BiancaClarissa_	girl
thetommcdermott	man
ShannonIhrke	girl
joellecaroline	man
JoinBAYADA	man
lisadobo88	boy
nedohon	dad
tmj_elp_manuf	man
triplerbailbond	man
tonyjdoran	man
DonaldMiralle	father
Okc_Matt	dad
ChrisEnriquez	man
chdbrwn	dad
ToddDurkin	trans
jltullman	man
PapoChasinPaper	boy
HeadframeSpirit	man
614Wolverine	grandpa
Swaggg_Daddy	boy
AdamDelGrosso	brother
bayoucityphoto	father
fatinsyifaa	man
melissamassello	girl
neilpwilkinson	dad
Noe_Alerts	man
deannabaisden	girl
edguerra93	man
SamiMichele11	mom
CaitJacob	mom
511nyRochester	trans
Landland_USA	man
JennyCz27	mom
MGSchneider76	man
DanielBaldonado	boy
mrbilbrey	father
Melsspot	sister
timstjohn	dad
TwannaHarris	mom
tmj_oh_manuf	man
tmj_FL_facmgmt	man
MotoKitten99	trans
koscheskev	boy
AmandaFrazierHI	mom
mteaches	mom
FamilyVapeShop	fluid
Martha__Lucia	sister
SamanthaEdwina	man
Willworks4you1s	man
whopper45	man
javorszky	trans
DrywallAnchor	sister
Songolo	man
AlexVMurphy	man
WitkopJosh	boy
sjobabe86	mom
realstevetheo	man
6mile_Kellz	father
M4reo	man
tmj_az_facmgmt	man
samudraNB	man
DonneAshlock	man
slushcult	boy
Boominyourmouth	man
ChadFalErickson	father
lauren_dorsey	gramma
tdphilli	father
20schemes	trans
LakeTravisAgent	mom
stgactor	man
tmj_aus_transp	trans
Hugo_Martz	man
susielove48	girl
MelyMM	man
PolishHam	man
georgedyjr	father
jppdiddy	father
JamesFeeley	man
hamletsvintage	girl
mmistretta691	mother
dannyklimetz	man
DAHULK310	man
DonnaRiopel	mom
realranta	man
EvanAnzalone	brother
abbeyrose512	mother
marklipton	man
13imdaddy	dad
jeremyinlondon	father
TheRealTavie	man
KathyBisbee	man
ohidesignblog	mama
got_TiTTiES	mom
tmj_AR_transp	trans
brigidcowdrey	mom
tammywhammy28	boy
cmurf77	papa
LoveCommaDionne	girl
el_e__	male
4everkirk	man
wosterhaus	man
foodloven	girl
VILO2308	man
TravisDCIF	girl
haqq_dabarber	father
kkossick	man
KathyWakile	mother
emmyannttu	mom
yssadalawa	mother
DJGadgetLynx	andro
D_Ato1	man
SorneFox	girl
drsefrit	father
Mattieologie	girl
SaraMirus	mom
Philippacw	man
RABIDSLOTH83	father
MikeManiacc	man
bettyxblue	girl
johnnycotton47	mother
F4PTM	man
MOBFAM	boy
PenaNow	mom
Ashlyn_Lowder	man
tmj_RI_transp	trans
gratefuled68	man
AmandaLeaOnAir	man
DJHiPPVA	aunt
kennethaaaron	brother
amberstarr82	mom
beautifuldiva35	mom
DanielleMelissa	girl
BigggSlim	uncle
jenstarsaden	mom
johnson_maren	girl
tmj_ksw_manuf	man
alexanderpavone	father
elatlboy	boy
FuzzTalkRadio	man
tmj_mgm_manuf	man
DanaEstrada682	man
BabyBBoop	trans
kayseabe	mama
wykeshahayes	mom
w8onhm	father
juanitohayburg	father
tmj_msp_hr	man
mozartianme	man
euneechan	man
tmj_orf_transp	trans
jerranalley	man
Motherhood_Cntr	mother
NoorHaddad	man
NewGirlinACity	girl
UpYourCupcake	mom
ItsLaLoca	sister
MJPineros	sister
PeterWolfinger	man
RayBrand1914	man
CHIraqBarbie	dad
UnTal_Edgar	man
elrobby12	male
Padsker	mom
lilbsaysso	uncle
LucianoDs_	man
358studios	dad
katetkacik	man
EvasiveMtrsprts	man
JacobWoolf	man
IrishJava	father
CalebRitchie	boy
jodi_renee	mom
kyleplacy	father
alschmick	mom
philippemora	man
meadmonsters	mom
katlynekahler1	girl
sandramc59	man
sabrina15718	girl
JenniferMJulian	trans
Osotucubeibi	man
abracamanda	man
khpgeorgia	mother
JQLouise	girl
RANDIBORDEN	girl
AllisonLeaAnn	man
krystlewitha_k	mom
EricaRHill	mom
tmj_CA_transp	trans
walshie802	girl
briannas9	girl
DriveMelton	trans
SocksandStripes	mom
pathayde	dad
kyleribeiro	man
debbie_savage	mom
elrealjmb	father
CervezaPlease	man
ArieleStewart	mother
Cocos1999	mama
btsblinggirl	girl
ShawnRTolliver	man
SHoneysett	girl
TsMadisonATL1	trans
THEfunkipino	dad
royteeluck	man
grooviedave	mom
frankmunozfight	man
SicaLai93	man
mcanski	trans
toddmulbarger	father
buddhaboy1	man
AlexBass5	man
JohnMBradshaw	boy
sarahnj11	mom
Tony_Olivieri	dad
StrengthCoachJ	man
psencikk	mom
chrisreighley	dad
kwschaff	trans
AshleyWaxman	girl
TONIMENAGE	man
MarciMay21	boy
franchiniamber	dad
PrettyBoyFloydS	boy
emilyurquhart	girl
rauldmiguel	dad
mkmaddox	man
next_segrel	dad
ericvessels	father
LifeIsLukeBryan	girl
PlexAthlete	man
AlexBromage	man
SeeMonterey	mom
savinggracenwa	trans
ianbentley	girl
mrusc96	father
keithpilston	father
noudles04	mother
detroitmarc	dad
soylari	mom
Ry3GuyCUSE	man
titanmike89	father
girlaboutdayton	girl
KateMarieAbbott	man
Swervvvv	girl
lailai100	mother
YoungKauffy	man
canusaypurple	man
UribeLa	mom
summx2	girl
FedoraMolly	man
RickRobie	father
tmj_mob_manuf	man
johnmstanley	man
TommyHaas13	father
lizmary1971	mother
BethEmerson41	girl
K_FioreStultz	man
zeldadead	man
pammeceballos	man
rodfaris	man
dlpowell1	father
erinpeep	girl
pcskigal	mom
m0nicajorge	man
sportyogalady	man
WFGFVielmann	man
uthmonster	father
naphtalitbryant	man
marlenvargas	mother
nurseangel7	mother
BowTieBandit12	man
kimmanningmusic	man
aptbphoto	man
krissyvarner1	mom
claulvg28	man
axiomdesignpdx	man
MykJordan	man
bjsullivanNC	dad
c21traceyA	mom
mad_iphone4	man
spazzzmatic	mom
scottriley	dad
mkchoe	mother
Giantpixie12	man
soccergurl42	grandpa
VincentMGee	man
dougiethefreshh	man
Im_Just_Bryan	man
HannahRose_____	girl
wesderby	father
pierapal	mom
thebumpnbeyond	mother
AndreaCupcake	girl
BellKendra	mother
kaylaglass	man
bworldarena	man
TDOGPhotography	man
efcbatsford	mom
JackboyLilkukuu	boy
theshabbybee	mom
UWThetaAlphaPhi	man
TiffanyLJ_	man
cferritto	dad
grantaidner	father
MoniqueWingard	man
ProSpeedRacing1	man
OneBikeMx	dad
ElNarcoC	dad
JoeRomero87	man
MiMi1PokerDiva	mother
thegreenfairy	girl
thatprk	man
SandymoMedia	man
erikawood	mom
tmj_UT_facmgmt	man
LittleTurtlesTP	man
LaceyBee3	trans
Muchalu	girl
williammccull13	male
NewZakkCity	man
patrickcmoore	dad
ERDAVI20	man
Char_Schwenke	man
CulumMomma	mom
jhan_yaa	mother
HSMDougieFresh	man
Jain7	dad
drewber	dad
LukieBabyyy	boy
Marinhojjmexico	man
IKEAtkinson	mother
BigRevelry	man
MelissaBefierce	mother
EdwinToureP	man
KoppGrace	mother
TimVanAuken	man
tippytippens	man
mattkhubbard	dad
DiOlmoos	dad
DuhItsKierra	boy
GregChanMANAGER	man
MONSTER_DC_18	man
susancakes1963	mother
adataghost	man
cmillette	father
tmj_ind_transp	trans
HankOnFood	boy
tmj_pit_manuf	man
tmj_pit_transp	trans
justinvarcie	man
cydgallery	man
CherieBTay	man
Riot_Craig	father
LaurenE_5H4Life	girl
Workyourcloset	mama
kayleelayken	brother
Harlemfilmguy	father
elljaycee626	boy
CathrynTheBrit	boy
raeannamccleve	boy
jaimexsolis	dad
martinbihl	man
FadingAd	uncle
mrappian	man
katies2r	man
Pastor_Douglas	father
CathrynFarley	girl
themollycameron	trans
galileo_orozco	man
Single_Grls	girl
ToddAimez	father
SliMasterJ13	man
rg1nakoa	man
Kwtanner	mother
todd_coder	mother
chrisquinn	man
tmj_dfw_transp	trans
isophil	father
AaronLaMonica	man
CHECKoutUFO	man
Dawsonbass	father
arnobb	man
pacifica69	man
dovey2316	man
KKashifT	man
ktwood7	man
ADouglasWMC	father
FullyChiefy	man
Happilytaken212	man
milenaruizdiaz	dad
ATURNERARCHIVES	man
paultriukas	man
TingallsDesign	man
DamnShesBlazin	man
mollystarkdean	man
victorlund	dad
jludingtonx	man
ButchCrassidy	mother
suziedamas	man
FernandoLuis50	man
robtroy87	boy
tarinadoolittle	man
emmbeee	mama
DjQuest9	brother
H00KEDONFITNESS	man
SavvyShort	girl
nickgadna	father
dj_drect09	man
IdleWildManor	man
phil_franks	man
ljwhitehaus	mother
BLifeManvel	man
CollectionBride	man
Paul_PJM	man
staceylawrence1	man
klumpmeister	boy
KatrinaHSmith	mother
SocialDelray	man
Steve_Grad	dad
clayj5815	man
quilterliz	mom
fbrglssmnfsto	father
JGJennR	man
deanzrmo	boy
jenridcat	mom
TNPPhillyRHPS	trans
TonyLazz	dad
cwils26	dad
obeymehrichard	boy
kamanaka	mom
mcallisters	boy
Chasing_Sammee	man
spintotampabay	mom
brianmetzler	man
FluxRegina	man
AMPtrain	man
salotevand	mom
karjo33	trans
AllisonAndrews	mom
baronesskelly	girl
DanielSanMMA	man
holly954wood	boy
Hugos_Art	girl
MarcLadia	man
andreinaleonb	girl
ImSashaHendrix	mother
AirshipAdmiral	papa
gregorybarfield	dad
cocomontrese	man
cititrendsjobs	man
Agfossil	mom
marina95266517	mom
EvolveLiving	man
SFarhart60	mom
JakeBacaner	man
simpsonbiohack	mom
DeniseFlores	mother
MrKLM	man
Coreylw72	man
GiantsTransport	trans
AlexxPetrella	girl
bethwadephoto	mother
lif75	father
obrienwrite	man
GymConsultant	man
lasocialkarma	man
trevorlc	man
BrianJohnsonXXX	dad
_CNaughty	father
paulbazinet	man
claaire_marie	man
LilBitSouth	mama
__Coleman__15	man
ThaPeachyOne	mother
GoProGirlMiami	girl
Vetmomof2	mom
thesingerjoshk	girl
tmj_bos_hr	man
TrishaTrixie	man
JJZanti	girl
tmj_IL_transp	trans
jlmassimino	dad
mfreatman	mom
dmb_swaggin	boy
tmj_MB_retail	man
CrowdFundYouth	father
ChefBoyZarDee	father
ManulifeJobs	man
Uhate2likeme	father
UrbanLegend_ENT	man
_spcanady	father
DJLILMAN973	man
msmeredithrose	girl
krista_rn	mom
76jewell	man
tariksevimli	man
MissyandMax	girl
samantha3556	mom
napaprivatetour	trans
ATLIndyTV	man
sharongadbois	mom
Sovann80	brother
ctweddings	man
MarianaHeAg	man
EricHinman	man
JUANMANUELPHOTO	man
mizperu	girl
docrouncee	man
mamacani007	mother
iRobTweets	man
Kryyrose	mom
markjcartier	father
tmj_ar_hr	man
matt_turrigiano	father
DeepLearningApp	man
EmoRedEvilRose	man
GregPanas	man
midlifecrashes	girl
djraytard	man
MartiniMonkey70	father
imjunipa	mother
tmj_cae_hr	man
mdgjedde	trans
NovelStrumpet	boy
jakedimare	brother
IkeGbruh	man
scrapbook_gal75	man
mistav0nsta	man
kanzlei_lexa	man
julialane2016	man
em_fitt	girl
michelenizza	mother
Mart4l_oneL	man
Maureen_castle1	girl
KandiRanson	girl
dianamcqueen	mom
AndikaGY_14	man
veebloom	man
SaraGThurston	girl
KatieDeLuca	mom
FumandoMotaSiem	man
makeupmaureen	mom
bolastname	man
alexandriahall	man
Mia12Afterglow	man
joseottieri	man
JAGSGIRL904	mom
aByrdseyephoto	mom
Marge_Wang	girl
WadeHTaylor	father
stephcarper	girl
dlazaratos	father
kirstyinsanity	man
h_air_eee	mom
JoshSauers	dad
tmj_LAH_HR	man
cutiehotMOM	mom
VeggieMum65	man
MsAlexandraV	mom
BFTdawg	dad
Otherwild	man
MariahHaberman	man
ColeyOuellette	girl
ipond317	man
jghjnk	dad
tinyt187	father
kaileecwright	mama
carickmiller	mom
winelover64	mother
tmj_tuc_manuf	man
AaronStallworth	man
IamPoettis	mom
Salmanims	mother
Photomunkey	queer
djfuters	dad
jeksgtz	man
tmj_rdu_manuf	man
Sequayah	aunt
AGinNEIowa	father
ProgressingSF	man
tmj_LA_transp	trans
melissadue1	mom
kamhubbard	dad
scobbx	mother
EasternCCE	trans
toddagross	father
carriebdrost	trans
recorsino	male
artielombardi	dad
nmarando	mom
dcwbysfn22	boy
drmo87	mom
anniElise2511	man
rickkelley365	father
MeghanLand	girl
DJJohnMichael51	man
IMSQUEAKYMONROE	mom
IanMikutel	man
JessieZapo	girl
lisa_mccubbin	mother
nicolekamel16	girl
sfrankiexo	man
PartiesConnieM	mother
LGYourCarGuy	father
daveahlman	man
tswizzle1997	man
sramired	man
haggaret	father
NESST6	trans
tmj_njn_transp	trans
leesuann	girl
BONNiE__B	girl
MacBryceee	mama
BarryAce	boy
AlecMagee	boy
VTAgLifeSci	trans
FerchaPaniagua	dad
LV2BFITINC	man
Fit4DawnDC	mom
DJSoundwave1	man
theblushblonde	girl
CalebLyons	dad
kayleymarchant	man
OsielSequera	man
DaMENACElo37	boy
tmj_sac_transp	trans
CornishGroup	man
Kathleen_Garvin	trans
ErikaMezzo	mama
juanlarrazabal	boy
fitsoldiers	man
genechan	man
bteaster	father
maQandSuz	man
Ms_Fit_Mix_ALot	mom
ChaunHorton	man
Fondalovesgems	mother
nailsbymei	man
WhitAlexander	mom
djdstar	man
Havokmon	father
actionkarate	trans
JannaSlye	mother
maripops	boy
unvegan	man
BelleAngel777	mom
virusventor	boy
marianinnaa	man
TheSunWasBright	gramma
macmixing	boy
AzaleaInn	man
mst0ne	man
iampatriciaaah	mom
PJamo18	girl
DizzyCleanFace	man
Lacie_Glenn	man
KinkzCoilzCurlz	girl
freduhl	dad
elh2005	girl
reeny_mckenney	mother
BluesNCards_85	man
FlawsofCouture	girl
TheRealNoodlez_	man
maryjaneb68	mom
dillydill26	boy
pchak	dad
stephentarruda	father
AndyStettler	man
HeathHerrera	man
MichaelDevenney	man
Angelic_Photos	boy
breadchastick03	man
KT_Kazoo	sister
tourdefranz	boy
freckscrosby	mom
stuepperson	father
mariotaku	andro
stxtigers	brother
weepnangel	girl
Megan_Sparkz	girl
AOBMOB22	mother
frwarren	father
gervanmenezes	father
HuskerDad3	father
kwhitestudios	man
TonyChiba	father
devinwalker660	mom
RBCMichaelNitz	man
pamelaWshaw	mother
WildlandsTrust	man
MaddieStrunsee	girl
tbzproduction	man
GeekAaron	father
aneliflores	queer
m_castrolopez	man
thinkdsignprint	brother
jjclohessy	man
b3tsy73420	andro
bushwickkeith	father
alejpoop	dad
thejoshstrange	dad
EuniceArias	man
GinsonSpeich	dad
faseidl	dad
artsvdo	trans
MalebCabrey	man
DJFLYBOY_ANT	boy
AGMSports	trans
The_Chamanas	man
screagar	man
Edith_Roysdon	mom
brendaodette19	mom
MrFreshFace	man
10Carden	man
tmj_san_transp	trans
JanellLynn77	girl
tmj_cao_transp	trans
czupermonay	mom
SiNfULsiNCERE	girl
tmj_scc_transp	trans
CDButler	father
DainUnicorn	trans
LUXMGT	man
sarahaware	mom
LilJediElf	male
Vivalyk	man
oswaldofer	man
DJ_Oso_Fresh	father
sid_8766	father
ayers_jolene	mother
itsMe_Raquel_	mom
tmj_AR_facmgmt	man
